Cidade,area,quartos,banheiro,estacionamento,animais,Valor do Aluguel,Iptu,Seguranca Incendio,total
Sao Paulo,70,2,1,1,acept,3300,211,42,3553
Sao Paulo,320,4,4,0,acept,4960,1750,63,6773
Porto Alegre,80,1,1,1,acept,2800,0,41,2841
Porto Alegre,51,2,1,0,acept,1112,22,17,1151
Sao Paulo,25,1,1,0,not acept,800,25,11,836
Sao Paulo,376,3,3,7,acept,8000,834,121,8955
Rio de Janeiro,72,2,1,0,acept,1900,85,25,2010
Sao Paulo,213,4,4,4,acept,3223,1735,41,4999
Sao Paulo,152,2,2,1,acept,15000,250,191,15441
Rio de Janeiro,35,1,1,0,acept,2300,35,30,2365
Sao Paulo,26,1,1,0,acept,2100,150,27,2277
Campinas,46,1,1,1,acept,580,43,8,631
Sao Paulo,36,1,1,0,acept,2100,70,27,2197
Sao Paulo,55,1,1,1,acept,4200,224,54,4478
Sao Paulo,100,2,2,2,acept,4370,17,56,4443
Campinas,330,4,6,6,acept,8000,328,121,8449
Sao Paulo,110,2,2,1,acept,3000,122,39,3161
Rio de Janeiro,88,2,3,1,not acept,3500,221,16,3737
Rio de Janeiro,56,2,1,0,acept,1220,0,16,1236
Sao Paulo,600,4,5,6,acept,12000,9500,181,21681
Sao Paulo,100,7,4,0,acept,3800,118,58,3976
Belo Horizonte,42,1,1,1,not acept,2690,172,36,2898
Sao Paulo,160,3,2,2,acept,1900,167,25,2092
Sao Paulo,35,1,1,0,acept,1100,3,14,1117
Rio de Janeiro,90,3,2,1,acept,1800,118,24,1942
Sao Paulo,49,1,1,1,acept,3500,42,45,3587
Sao Paulo,41,1,1,1,not acept,3000,0,39,3039
Belo Horizonte,64,2,2,1,acept,1500,80,20,1600
Campinas,208,3,2,4,acept,3180,100,48,3328
Sao Paulo,20,1,1,0,acept,1800,130,23,1953
Sao Paulo,55,2,2,2,acept,1068,142,14,1224
Sao Paulo,32,1,1,0,acept,1700,29,22,1751
Sao Paulo,80,2,2,1,acept,2550,216,33,2799
Rio de Janeiro,45,1,1,1,acept,2500,593,33,3126
Sao Paulo,350,4,4,3,acept,4000,500,51,4551
Porto Alegre,38,1,1,2,not acept,1750,0,26,1776
Sao Paulo,30,1,1,0,acept,1600,0,21,1621
Belo Horizonte,80,3,2,1,acept,11000,425,181,11606
Sao Paulo,70,2,1,0,not acept,1150,59,18,1227
Porto Alegre,40,1,1,1,acept,2990,0,44,3034
Sao Paulo,300,4,6,4,acept,12000,1584,153,13737
Sao Paulo,240,3,2,3,acept,3500,292,53,3845
Belo Horizonte,200,4,2,1,not acept,2550,9,34,2593
Belo Horizonte,45,1,1,1,acept,1631,192,12,1835
Sao Paulo,360,4,5,0,acept,6410,2000,82,8492
Sao Paulo,40,1,1,1,acept,2829,0,33,2862
Belo Horizonte,100,3,1,0,not acept,1220,10,17,1247
Porto Alegre,42,1,1,2,acept,1770,17,26,1813
Campinas,250,3,3,2,acept,1700,256,22,1978
Campinas,48,1,1,1,acept,1600,59,21,1680
Rio de Janeiro,90,3,3,1,acept,3800,147,49,3996
Sao Paulo,45,1,2,1,acept,3900,150,50,4100
Rio de Janeiro,150,2,3,4,acept,4000,700,52,4752
Sao Paulo,60,2,1,0,acept,1445,0,19,1464
Sao Paulo,31,1,1,0,acept,2350,56,30,2436
Sao Paulo,210,4,5,4,not acept,9000,772,115,9887
Sao Paulo,280,3,1,2,acept,6000,113,91,6204
Campinas,93,2,3,2,acept,5500,133,70,5703
Porto Alegre,75,3,2,1,acept,1800,109,27,1936
Sao Paulo,194,3,4,3,acept,4000,70,61,4131
Sao Paulo,41,1,1,1,acept,4000,131,51,4182
Rio de Janeiro,65,1,1,1,acept,5100,250,66,5416
Sao Paulo,70,2,1,1,acept,2150,67,28,2245
Sao Paulo,278,4,5,2,acept,9000,1261,115,10376
Rio de Janeiro,35,1,1,0,acept,1521,21,20,1562
Campinas,300,4,4,3,acept,6000,417,77,6494
Sao Paulo,61,2,1,1,acept,1850,0,24,1874
Rio de Janeiro,130,3,2,1,acept,1700,475,22,2197
Rio de Janeiro,80,2,1,1,acept,900,90,12,1002
Sao Paulo,164,4,4,2,not acept,5000,386,64,5450
Belo Horizonte,220,4,2,3,acept,2422,125,33,2580
Sao Paulo,45,1,1,0,acept,1050,46,16,1112
Sao Paulo,108,3,2,2,acept,5600,435,71,6106
Belo Horizonte,128,1,1,0,acept,2100,182,28,2310
Rio de Janeiro,60,1,1,0,not acept,1800,48,24,1872
Sao Paulo,250,4,5,4,acept,9800,998,125,10923
Porto Alegre,47,1,1,1,not acept,2200,0,33,2233
Belo Horizonte,170,4,3,4,not acept,2700,296,36,3032
Sao Paulo,45,1,1,0,not acept,1240,0,16,1256
Sao Paulo,42,1,1,1,acept,3500,123,45,3668
Sao Paulo,164,4,4,3,acept,6000,550,77,6627
Sao Paulo,70,3,1,1,acept,1020,200,13,1233
Porto Alegre,100,4,3,1,acept,2200,159,33,2392
Sao Paulo,64,2,2,2,acept,4500,440,58,4998
Belo Horizonte,68,2,1,1,acept,1200,27,16,1243
Belo Horizonte,75,2,2,2,not acept,2500,264,34,2798
Sao Paulo,600,4,4,4,acept,8500,3368,108,11976
Sao Paulo,63,2,2,0,not acept,1550,152,20,1722
Sao Paulo,145,3,4,3,not acept,6000,750,77,6827
Sao Paulo,85,2,2,2,not acept,2800,292,36,3128
Sao Paulo,254,4,4,4,acept,9000,1800,115,10915
Porto Alegre,350,4,4,4,acept,9000,359,160,9519
Sao Paulo,300,4,4,3,acept,3500,584,53,4137
Belo Horizonte,296,4,3,2,acept,13500,423,222,14145
Sao Paulo,64,2,2,2,acept,2800,30,36,2866
Sao Paulo,133,3,2,0,acept,2957,38,38,3033
Campinas,44,1,1,0,acept,550,12,7,569
Campinas,240,3,4,2,acept,3000,250,46,3296
Porto Alegre,70,3,2,1,acept,2500,8,37,2545
Sao Paulo,22,1,1,0,acept,2050,45,26,2121
Porto Alegre,50,1,1,1,acept,950,50,14,1014
Porto Alegre,67,3,2,2,acept,2200,50,33,2283
Sao Paulo,31,1,1,0,acept,2300,0,30,2330
Rio de Janeiro,90,2,1,1,acept,3468,191,45,3704
Rio de Janeiro,109,3,3,1,acept,3800,300,49,4149
Belo Horizonte,400,4,2,2,not acept,2500,74,41,2615
Sao Paulo,300,4,5,4,acept,14000,1167,211,15378
Campinas,284,4,3,3,acept,6000,483,77,6560
Porto Alegre,70,2,1,1,acept,2400,30,36,2466
Rio de Janeiro,309,4,5,4,acept,6500,682,84,7266
Sao Paulo,70,2,1,0,acept,2100,134,32,2266
Sao Paulo,360,3,4,1,acept,10000,584,127,10711
Sao Paulo,30,1,1,1,not acept,1500,0,20,1520
Campinas,80,2,2,2,acept,2200,171,28,2399
Belo Horizonte,133,4,4,3,not acept,7000,800,94,7894
Sao Paulo,38,1,1,1,not acept,2800,279,36,3115
Sao Paulo,73,2,2,1,acept,3500,100,45,3645
Sao Paulo,155,3,4,2,acept,2000,150,26,2176
Sao Paulo,63,2,2,1,acept,3200,50,41,3291
Sao Paulo,58,2,1,1,acept,1400,0,18,1418
Sao Paulo,48,1,1,0,not acept,3450,0,44,3494
Sao Paulo,210,3,4,3,acept,2790,834,36,3660
Belo Horizonte,100,3,2,2,acept,1600,183,22,1805
Sao Paulo,94,3,2,2,acept,3570,140,46,3756
Sao Paulo,94,3,3,2,acept,5010,395,64,5469
Sao Paulo,76,3,1,1,acept,2500,267,32,2799
Sao Paulo,192,3,3,2,acept,7800,634,99,8533
Sao Paulo,217,3,4,3,acept,6500,0,83,6583
Sao Paulo,68,2,1,1,acept,1400,35,18,1453
Sao Paulo,110,3,2,2,acept,2400,247,31,2678
Belo Horizonte,95,2,2,1,acept,1600,164,22,1786
Sao Paulo,900,4,6,8,acept,15000,4417,226,19643
Sao Paulo,34,1,1,0,not acept,1200,45,16,1261
Sao Paulo,192,3,4,3,acept,8000,0,102,8102
Porto Alegre,62,2,2,1,acept,1800,75,27,1902
Sao Paulo,180,3,3,4,acept,3700,184,56,3940
Campinas,44,1,1,0,acept,916,12,12,940
Belo Horizonte,100,2,1,1,not acept,1700,116,23,1839
Rio de Janeiro,140,3,3,1,not acept,1370,100,18,1488
Sao Paulo,170,3,3,3,acept,2800,648,36,3484
Sao Paulo,100,3,2,2,not acept,1600,150,25,1775
Sao Paulo,75,3,2,2,acept,1600,82,21,1703
Rio de Janeiro,52,2,1,0,acept,1200,43,16,1259
Campinas,999,5,7,8,acept,14000,667,211,14878
Sao Paulo,270,4,4,4,acept,7000,1500,89,8589
Belo Horizonte,50,2,1,1,acept,930,60,13,1003
Campinas,200,3,3,2,acept,2210,184,34,2428
Sao Paulo,71,2,2,0,acept,1920,100,25,2045
Sao Paulo,500,5,4,6,acept,13000,250,196,13446
Sao Paulo,60,2,1,0,acept,1080,94,17,1191
Sao Paulo,110,2,1,0,acept,1300,84,17,1401
Sao Paulo,210,3,3,4,acept,3294,276,50,3620
Sao Paulo,220,3,4,3,acept,6000,996,77,7073
Belo Horizonte,200,3,2,5,not acept,4000,204,66,4270
Sao Paulo,130,3,4,3,acept,4250,502,54,4806
Sao Paulo,65,2,2,2,acept,4000,245,51,4296
Sao Paulo,96,3,2,2,acept,3200,250,41,3491
Sao Paulo,660,4,5,5,acept,20000,1750,254,22004
Rio de Janeiro,107,3,2,0,acept,3200,270,42,3512
Rio de Janeiro,105,3,2,0,acept,2200,9,29,2238
Rio de Janeiro,100,3,2,0,acept,3290,109,43,3442
Sao Paulo,287,3,4,4,acept,9000,430,136,9566
Campinas,24,1,1,0,not acept,1180,9,15,1204
Sao Paulo,22,1,1,0,not acept,976,0,15,991
Sao Paulo,70,1,1,1,not acept,2529,142,39,2710
Porto Alegre,44,1,1,1,acept,1500,17,22,1539
Sao Paulo,150,3,2,2,not acept,2500,0,38,2538
Sao Paulo,90,1,2,2,acept,2900,220,37,3157
Sao Paulo,200,4,4,2,acept,2800,830,36,3666
Sao Paulo,320,8,4,0,acept,10500,350,158,11008
Porto Alegre,90,2,1,1,not acept,1700,110,25,1835
Sao Paulo,240,4,4,3,acept,2144,834,28,3006
Sao Paulo,154,4,3,3,acept,7000,1020,89,8109
Sao Paulo,60,2,2,2,acept,3230,284,41,3555
Campinas,101,3,2,0,acept,2380,91,31,2502
Porto Alegre,140,3,4,2,not acept,3090,0,55,3145
Sao Paulo,500,4,5,8,acept,15000,1850,226,17076
Sao Paulo,110,3,3,3,acept,2350,687,30,3067
Sao Paulo,110,3,3,2,acept,4800,50,73,4923
Belo Horizonte,90,2,2,2,acept,2000,84,27,2111
Sao Paulo,384,4,6,4,not acept,15000,344,191,15535
Sao Paulo,57,2,1,1,acept,1500,67,20,1587
Sao Paulo,160,3,3,2,acept,1500,419,20,1939
Sao Paulo,39,1,1,0,acept,1250,19,16,1285
Campinas,78,1,2,1,acept,2290,143,30,2463
Porto Alegre,36,1,1,1,acept,762,15,14,791
Campinas,70,2,1,1,acept,1200,0,16,1216
Belo Horizonte,45,1,1,1,not acept,3200,0,43,3243
Sao Paulo,200,3,4,3,acept,8500,1250,108,9858
Sao Paulo,100,3,3,3,acept,4300,120,65,4485
Sao Paulo,42,1,1,1,not acept,5000,0,64,5064
Sao Paulo,280,4,4,1,acept,8000,292,102,8394
Sao Paulo,28,1,1,1,not acept,2800,42,36,2878
Sao Paulo,30,1,1,0,not acept,1826,30,24,1880
Belo Horizonte,85,3,2,1,acept,1500,88,20,1608
Campinas,83,1,1,1,not acept,1080,59,14,1153
Campinas,85,3,2,2,acept,3300,150,42,3492
Belo Horizonte,90,3,2,2,acept,1600,105,22,1727
Belo Horizonte,50,2,1,0,acept,900,100,12,1012
Rio de Janeiro,50,1,1,0,acept,2900,134,38,3072
Belo Horizonte,300,3,2,3,not acept,6700,539,110,7349
Porto Alegre,39,1,1,0,acept,850,27,13,890
Sao Paulo,750,4,4,6,acept,15000,2084,226,17310
Porto Alegre,60,2,1,0,acept,1100,46,17,1163
Rio de Janeiro,68,2,1,0,not acept,1250,9,17,1276
Sao Paulo,70,2,1,1,acept,1250,50,16,1316
Sao Paulo,90,2,2,1,acept,6500,89,83,6672
Rio de Janeiro,258,5,6,0,acept,8700,670,133,9503
Sao Paulo,200,2,2,6,acept,4500,292,68,4860
Sao Paulo,123,2,2,2,acept,2990,625,38,3653
Sao Paulo,127,3,2,2,acept,2150,67,33,2250
Belo Horizonte,180,4,2,2,acept,1800,210,30,2040
Sao Paulo,110,3,2,0,not acept,2900,384,44,3328
Rio de Janeiro,70,2,2,1,acept,1719,77,23,1819
Sao Paulo,35,1,1,1,acept,3000,130,39,3169
Sao Paulo,219,3,2,2,acept,2900,150,44,3094
Rio de Janeiro,25,1,1,0,acept,700,0,10,710
Rio de Janeiro,170,4,5,0,acept,7100,639,92,7831
Rio de Janeiro,45,1,1,0,acept,1570,98,21,1689
Belo Horizonte,420,4,4,2,not acept,7000,200,115,7315
Porto Alegre,46,1,1,0,acept,1040,48,16,1104
Sao Paulo,145,3,3,2,acept,5800,250,74,6124
Belo Horizonte,59,2,2,1,acept,1100,59,15,1174
Belo Horizonte,225,4,3,0,acept,7500,466,100,8066
Sao Paulo,210,4,4,3,acept,4675,1110,60,5845
Porto Alegre,76,1,1,0,acept,1249,52,19,1320
Sao Paulo,220,3,4,3,not acept,5150,1250,66,6466
Sao Paulo,109,3,2,2,acept,2500,134,32,2666
Belo Horizonte,95,2,1,1,acept,1000,120,14,1134
Sao Paulo,32,1,1,0,not acept,1500,50,20,1570
Sao Paulo,480,4,6,5,acept,15000,3063,191,18254
Sao Paulo,53,1,1,1,acept,4390,200,56,4646
Sao Paulo,40,1,1,0,not acept,780,17,12,809
Sao Paulo,50,1,1,1,acept,3223,100,41,3364
Sao Paulo,60,1,1,0,acept,1300,255,20,1575
Porto Alegre,64,2,2,2,not acept,1500,50,22,1572
Rio de Janeiro,140,3,3,2,acept,12000,535,155,12690
Sao Paulo,121,3,3,1,acept,2040,334,26,2400
Campinas,43,1,1,1,acept,2100,84,27,2211
Sao Paulo,20,1,1,1,not acept,1360,0,18,1378
Campinas,58,2,1,1,acept,950,11,13,974
Belo Horizonte,570,5,6,7,acept,8330,873,137,9340
Sao Paulo,88,2,1,1,acept,2790,0,36,2826
Sao Paulo,89,3,2,2,acept,6000,184,77,6261
Porto Alegre,47,1,1,1,not acept,2200,0,33,2233
Sao Paulo,40,1,1,0,acept,1100,50,17,1167
Rio de Janeiro,40,1,1,0,acept,1950,91,26,2067
Rio de Janeiro,60,1,2,1,acept,750,80,10,840
Sao Paulo,25,1,1,0,acept,1650,0,21,1671
Porto Alegre,50,2,1,0,acept,1130,30,17,1177
Porto Alegre,90,3,1,0,acept,1130,55,17,1202
Sao Paulo,173,3,3,3,acept,2000,825,26,2851
Campinas,91,3,2,2,acept,2250,175,29,2454
Sao Paulo,90,3,2,2,not acept,1200,109,16,1325
Sao Paulo,530,5,6,4,acept,15000,5000,191,20191
Belo Horizonte,155,1,4,0,not acept,2790,64,38,2892
Sao Paulo,40,1,1,0,not acept,1300,0,17,1317
Sao Paulo,296,4,5,3,acept,15000,0,191,15191
Sao Paulo,87,3,2,1,acept,1400,200,18,1618
Sao Paulo,300,3,3,5,acept,5000,584,76,5660
Sao Paulo,136,3,3,3,acept,4206,364,54,4624
Sao Paulo,52,2,1,0,acept,1340,0,17,1357
Porto Alegre,94,2,2,2,acept,2900,230,43,3173
Rio de Janeiro,300,4,5,3,acept,12750,750,165,13665
Rio de Janeiro,100,3,3,1,acept,3229,100,42,3371
Sao Paulo,500,4,6,3,acept,7300,2536,110,9946
Sao Paulo,240,3,4,3,acept,4950,1000,63,6013
Belo Horizonte,308,2,3,3,acept,2000,171,33,2204
Sao Paulo,350,4,5,4,acept,4590,1334,59,5983
Sao Paulo,75,2,2,0,acept,1450,0,19,1469
Sao Paulo,155,3,2,3,acept,11700,667,149,12516
Sao Paulo,260,3,5,4,acept,6000,1468,77,7545
Sao Paulo,80,2,2,1,not acept,1500,184,23,1707
Rio de Janeiro,85,3,1,1,acept,1998,87,26,2111
Sao Paulo,120,2,2,2,not acept,3500,375,45,3920
Sao Paulo,100,2,2,1,acept,1970,0,30,2000
Sao Paulo,240,4,5,4,not acept,3500,717,45,4262
Sao Paulo,360,7,6,6,acept,5270,245,80,5595
Sao Paulo,42,1,1,0,not acept,1100,0,17,1117
Sao Paulo,33,1,1,1,acept,2800,112,36,2948
Rio de Janeiro,48,1,1,0,not acept,1020,53,14,1087
Rio de Janeiro,36,1,1,0,acept,1130,42,15,1187
Sao Paulo,270,6,3,6,acept,4500,417,68,4985
Campinas,75,2,1,1,acept,1200,121,16,1337
Rio de Janeiro,46,2,1,0,not acept,1600,0,21,1621
Sao Paulo,350,3,3,3,not acept,10000,1292,151,11443
Porto Alegre,131,3,3,1,acept,1750,121,26,1897
Campinas,90,3,2,1,acept,1300,129,17,1446
Rio de Janeiro,26,1,1,0,not acept,1650,120,22,1792
Rio de Janeiro,44,1,1,0,acept,1100,14,15,1129
Sao Paulo,70,2,2,0,acept,1880,0,29,1909
Belo Horizonte,40,1,1,0,not acept,900,0,15,915
Belo Horizonte,320,4,2,4,acept,3200,206,53,3459
Sao Paulo,213,2,2,3,acept,5150,0,78,5228
Sao Paulo,80,2,1,0,not acept,1100,0,14,1114
Campinas,70,1,1,0,acept,800,30,11,841
Rio de Janeiro,60,2,1,1,acept,1500,25,20,1545
Sao Paulo,270,4,4,4,acept,12850,1834,163,14847
Rio de Janeiro,70,2,1,1,acept,1300,44,17,1361
Porto Alegre,300,6,2,2,acept,6000,242,107,6349
Sao Paulo,220,4,5,3,acept,12000,750,153,12903
Porto Alegre,64,2,2,2,acept,1600,34,24,1658
Rio de Janeiro,80,3,3,1,not acept,1470,0,19,1489
Sao Paulo,56,1,1,0,acept,2500,81,32,2613
Sao Paulo,161,4,3,2,acept,10000,467,127,10594
Sao Paulo,35,1,1,0,acept,1350,0,18,1368
Sao Paulo,720,4,6,5,acept,12750,2613,192,15555
Sao Paulo,280,4,5,4,not acept,3200,750,41,3991
Porto Alegre,96,3,2,0,acept,2100,84,31,2215
Campinas,236,3,4,4,acept,11000,440,140,11580
Sao Paulo,81,3,2,1,acept,1510,0,20,1530
Sao Paulo,62,2,1,1,acept,1650,92,21,1763
Belo Horizonte,125,3,2,0,acept,1200,69,16,1285
Sao Paulo,37,1,1,1,acept,4150,110,53,4313
Sao Paulo,60,2,2,1,acept,4000,200,51,4251
Sao Paulo,230,4,2,3,acept,5000,1551,64,6615
Sao Paulo,210,4,5,2,acept,8500,0,108,8608
Sao Paulo,450,4,3,8,acept,14000,175,211,14386
Sao Paulo,234,3,5,4,acept,3680,400,56,4136
Belo Horizonte,135,4,3,2,not acept,2450,308,33,2791
Sao Paulo,395,4,5,3,acept,6000,122,91,6213
Porto Alegre,92,2,2,1,acept,1700,67,25,1792
Sao Paulo,412,3,5,6,acept,3952,459,51,4462
Sao Paulo,42,1,1,1,acept,5300,100,68,5468
Sao Paulo,33,1,1,0,not acept,3000,125,39,3164
Porto Alegre,28,2,1,1,acept,600,0,11,611
Sao Paulo,190,4,4,2,not acept,4450,223,67,4740
Sao Paulo,165,4,3,3,acept,6300,1292,80,7672
Porto Alegre,44,1,1,0,acept,1200,20,18,1238
Sao Paulo,60,2,1,1,acept,1275,109,17,1401
Sao Paulo,380,3,3,2,acept,11000,1084,140,12224
Rio de Janeiro,73,2,1,0,acept,830,120,11,961
Belo Horizonte,19,1,1,0,acept,1100,85,15,1200
Campinas,230,3,5,4,acept,7500,0,96,7596
Porto Alegre,37,1,1,1,acept,2500,0,37,2537
Sao Paulo,124,3,2,3,acept,6600,300,84,6984
Rio de Janeiro,115,3,2,1,acept,2680,114,35,2829
Campinas,600,3,3,4,acept,5500,384,83,5967
Rio de Janeiro,700,5,5,4,acept,15000,1667,229,16896
Porto Alegre,35,1,1,0,acept,815,17,12,844
Belo Horizonte,15,1,1,0,not acept,1100,0,15,1115
Campinas,80,3,2,1,acept,1450,125,19,1594
Porto Alegre,48,1,1,0,acept,700,38,11,749
Belo Horizonte,96,3,2,1,acept,1500,137,20,1657
Sao Paulo,150,3,2,1,acept,6715,340,86,7141
Belo Horizonte,105,3,2,2,not acept,3300,390,44,3734
Belo Horizonte,204,4,4,4,not acept,10000,760,134,10894
Rio de Janeiro,125,3,1,2,acept,2600,170,33,2803
Rio de Janeiro,50,2,1,0,not acept,2300,50,30,2380
Sao Paulo,250,3,4,3,not acept,3740,234,57,4031
Sao Paulo,300,3,4,3,acept,2000,1250,26,3276
Sao Paulo,80,2,1,1,acept,1500,55,23,1578
Rio de Janeiro,130,3,4,1,not acept,1400,334,19,1753
Sao Paulo,120,2,3,0,acept,3300,195,42,3537
Sao Paulo,540,3,3,4,acept,15000,3500,191,18691
Sao Paulo,23,1,1,0,acept,2100,41,27,2168
Sao Paulo,15,1,1,0,not acept,2500,0,32,2532
Sao Paulo,72,1,2,2,acept,4000,200,51,4251
Rio de Janeiro,95,3,2,2,acept,2300,122,30,2452
Sao Paulo,330,4,5,4,acept,10000,1119,127,11246
Sao Paulo,75,2,2,2,not acept,6600,400,84,7084
Sao Paulo,53,1,1,1,acept,4398,200,56,4654
Sao Paulo,178,3,2,1,not acept,1900,180,25,2105
Sao Paulo,150,3,2,0,acept,4000,24,61,4085
Sao Paulo,50,2,1,1,acept,1200,30,16,1246
Sao Paulo,150,3,2,1,not acept,2500,59,38,2597
Porto Alegre,25,1,1,0,acept,984,11,15,1010
Sao Paulo,210,3,4,4,not acept,12000,1155,153,13308
Belo Horizonte,75,3,2,1,acept,1500,75,20,1595
Belo Horizonte,200,2,4,3,acept,15000,827,200,16027
Sao Paulo,350,4,4,0,acept,8000,989,121,9110
Porto Alegre,49,2,1,1,acept,1150,30,17,1197
Porto Alegre,40,1,1,0,not acept,2000,0,30,2030
Sao Paulo,45,1,1,1,not acept,4200,350,54,4604
Sao Paulo,46,1,1,1,not acept,7600,118,97,7815
Sao Paulo,80,2,2,2,acept,11000,0,140,11140
Sao Paulo,30,1,1,0,acept,2850,0,37,2887
Sao Paulo,80,2,2,2,acept,2200,173,34,2407
Rio de Janeiro,105,2,2,1,acept,1530,134,20,1684
Belo Horizonte,105,3,2,2,acept,2000,219,27,2246
Sao Paulo,114,3,1,0,acept,2570,150,39,2759
Sao Paulo,200,3,3,4,acept,7000,425,106,7531
Porto Alegre,120,3,3,2,acept,3000,167,44,3211
Sao Paulo,60,2,2,1,acept,4000,21,51,4072
Sao Paulo,90,2,1,1,acept,3000,50,39,3089
Rio de Janeiro,53,2,1,0,not acept,1800,50,24,1874
Sao Paulo,80,2,2,5,acept,3000,59,46,3105
Campinas,87,4,2,2,acept,1600,106,21,1727
Rio de Janeiro,110,3,1,1,acept,5000,188,65,5253
Belo Horizonte,113,4,2,1,acept,4000,429,54,4483
Sao Paulo,170,3,2,2,not acept,5000,423,64,5487
Sao Paulo,150,3,2,0,not acept,3000,42,39,3081
Porto Alegre,60,2,2,1,acept,1500,51,22,1573
Porto Alegre,43,1,1,0,not acept,2100,66,31,2197
Sao Paulo,130,3,2,2,acept,3500,0,45,3545
Sao Paulo,69,3,2,0,acept,1900,185,25,2110
Campinas,306,3,2,2,acept,2500,422,38,2960
Sao Paulo,187,3,2,3,acept,3500,193,53,3746
Sao Paulo,385,3,4,3,acept,9000,1500,136,10636
Sao Paulo,355,4,4,3,acept,7300,660,110,8070
Porto Alegre,90,2,1,1,acept,1100,380,17,1497
Sao Paulo,190,3,4,4,acept,5000,275,76,5351
Campinas,181,2,1,2,acept,1400,132,22,1554
Sao Paulo,350,3,5,4,acept,3490,1750,45,5285
Belo Horizonte,168,5,3,2,acept,2900,408,39,3347
Rio de Janeiro,73,2,1,0,acept,2800,204,37,3041
Sao Paulo,378,5,5,4,acept,3000,2000,39,5039
Campinas,60,2,1,1,acept,1300,180,20,1500
Belo Horizonte,362,4,5,0,not acept,15000,1975,200,17175
Sao Paulo,90,3,2,0,acept,1700,136,26,1862
Rio de Janeiro,42,1,1,0,not acept,1973,79,26,2078
Rio de Janeiro,56,2,1,1,acept,1000,88,13,1101
Sao Paulo,16,1,1,0,not acept,850,30,11,891
Sao Paulo,90,2,2,2,not acept,10000,0,127,10127
Belo Horizonte,67,1,1,0,acept,850,55,12,917
Sao Paulo,488,4,3,3,acept,6400,1214,82,7696
Rio de Janeiro,30,1,1,0,acept,1100,60,15,1175
Sao Paulo,290,6,3,4,acept,8000,1525,121,9646
Sao Paulo,266,3,3,4,acept,6400,1500,82,7982
Campinas,47,2,1,1,acept,900,25,12,937
Rio de Janeiro,590,6,6,2,acept,8000,975,122,9097
Sao Paulo,900,4,9,8,acept,15000,5700,226,20926
Sao Paulo,86,2,1,1,acept,2200,110,34,2344
Sao Paulo,290,3,3,2,acept,15000,1000,226,16226
Porto Alegre,84,3,2,2,acept,3300,100,49,3449
Sao Paulo,160,3,1,2,acept,5000,225,76,5301
Sao Paulo,37,1,1,0,not acept,3500,127,45,3672
Campinas,73,3,1,1,acept,850,46,11,907
Sao Paulo,350,4,5,5,acept,15000,2400,191,17591
Rio de Janeiro,57,1,1,0,acept,1100,10,15,1125
Campinas,48,1,1,0,acept,650,21,9,680
Rio de Janeiro,30,1,1,0,acept,800,25,11,836
Campinas,198,6,3,4,acept,2000,145,31,2176
Porto Alegre,47,1,1,0,not acept,1000,59,15,1074
Porto Alegre,60,2,1,1,acept,800,22,12,834
Sao Paulo,230,3,3,0,acept,5000,109,64,5173
Belo Horizonte,90,2,1,1,not acept,1520,0,25,1545
Rio de Janeiro,129,3,2,1,acept,3255,167,42,3464
Sao Paulo,240,4,4,4,acept,6672,417,85,7174
Porto Alegre,55,1,1,0,acept,1020,29,15,1064
Porto Alegre,52,1,1,0,acept,1200,42,18,1260
Sao Paulo,250,3,4,3,acept,6000,1089,77,7166
Sao Paulo,200,3,2,2,acept,10000,1121,127,11248
Belo Horizonte,312,4,3,3,acept,2300,463,31,2794
Sao Paulo,230,5,5,3,acept,9900,620,149,10669
Sao Paulo,72,2,2,2,acept,2480,209,32,2721
Sao Paulo,55,2,1,0,acept,2400,24,31,2455
Rio de Janeiro,72,2,2,1,not acept,3600,133,47,3780
Sao Paulo,50,2,1,0,acept,1200,83,19,1302
Sao Paulo,17,1,1,0,acept,2700,5,35,2740
Belo Horizonte,160,3,3,2,acept,2400,263,32,2695
Sao Paulo,214,4,4,3,acept,6520,1187,83,7790
Rio de Janeiro,65,1,1,0,acept,1800,30,24,1854
Sao Paulo,136,3,2,1,not acept,6500,267,47,6814
Porto Alegre,70,2,2,1,acept,1900,57,28,1985
Porto Alegre,38,1,1,0,acept,650,350,10,1010
Sao Paulo,450,8,5,5,acept,8000,1000,121,9121
Rio de Janeiro,67,2,1,1,acept,2200,130,29,2359
Sao Paulo,20,1,1,0,not acept,1100,35,14,1149
Sao Paulo,41,1,1,0,acept,1530,60,20,1610
Sao Paulo,50,2,1,1,acept,1550,7,20,1577
Sao Paulo,205,3,3,3,acept,5525,575,84,6184
Sao Paulo,100,3,2,1,acept,3300,500,50,3850
Sao Paulo,190,3,4,4,acept,15000,1160,191,16351
Belo Horizonte,45,2,1,0,acept,1350,0,23,1373
Campinas,57,1,1,1,acept,800,66,11,877
Porto Alegre,88,1,2,2,acept,1600,40,24,1664
Sao Paulo,70,1,1,1,acept,3400,80,44,3524
Sao Paulo,76,2,2,0,acept,2800,0,36,2836
Rio de Janeiro,36,1,1,0,acept,1370,29,18,1417
Porto Alegre,61,2,2,2,acept,2500,42,37,2579
Sao Paulo,280,4,3,6,acept,12500,706,188,13394
Sao Paulo,480,5,6,3,acept,5000,1000,76,6076
Campinas,45,1,1,1,acept,1950,0,25,1975
Sao Paulo,42,1,1,0,acept,1500,184,20,1704
Porto Alegre,62,2,1,0,acept,736,28,11,775
Sao Paulo,38,2,1,0,acept,1500,0,20,1520
Sao Paulo,44,1,1,1,not acept,2400,0,31,2431
Sao Paulo,75,3,2,2,acept,2800,167,36,3003
Rio de Janeiro,66,2,1,1,acept,1250,0,17,1267
Sao Paulo,125,3,3,2,acept,2800,38,43,2881
Campinas,62,2,1,2,acept,1500,90,20,1610
Sao Paulo,77,2,1,1,acept,3100,464,40,3604
Sao Paulo,136,2,4,2,acept,4800,242,61,5103
Sao Paulo,200,4,2,1,acept,5000,328,64,5392
Sao Paulo,35,1,1,0,not acept,1305,0,17,1322
Sao Paulo,250,4,3,2,acept,4500,100,68,4668
Sao Paulo,90,2,2,2,acept,4100,0,62,4162
Campinas,72,2,2,1,acept,850,9,11,870
Sao Paulo,168,3,3,5,acept,3500,184,45,3729
Porto Alegre,360,3,4,3,acept,13200,500,193,13893
Campinas,38,1,1,1,acept,740,30,10,780
Sao Paulo,23,1,1,1,acept,2300,59,30,2389
Porto Alegre,440,3,3,3,not acept,10500,84,154,10738
Sao Paulo,120,3,3,2,acept,3500,109,45,3654
Rio de Janeiro,90,2,2,0,acept,2500,84,33,2617
Porto Alegre,125,4,2,0,acept,1632,150,14,1796
Sao Paulo,200,3,4,3,acept,5058,1200,65,6323
Sao Paulo,190,3,3,2,acept,3260,292,42,3594
Belo Horizonte,123,3,2,1,acept,2600,143,35,2778
Campinas,53,2,1,1,acept,2000,41,26,2067
Rio de Janeiro,70,2,1,1,acept,2180,60,29,2269
Sao Paulo,90,2,2,2,acept,12200,454,155,12809
Sao Paulo,95,3,2,0,acept,1590,0,24,1614
Campinas,74,3,1,1,acept,900,40,12,952
Sao Paulo,64,1,1,1,not acept,3600,0,46,3646
Sao Paulo,155,4,5,3,not acept,6000,625,77,6702
Rio de Janeiro,125,3,1,2,not acept,2200,159,29,2388
Sao Paulo,40,1,1,1,acept,1580,25,21,1626
Porto Alegre,350,3,2,4,acept,6522,492,116,7130
Belo Horizonte,417,3,5,8,acept,7650,450,126,8226
Porto Alegre,350,4,4,4,acept,6000,192,107,6299
Sao Paulo,40,1,1,1,not acept,2800,100,36,2936
Sao Paulo,30,1,1,1,not acept,3500,127,45,3672
Sao Paulo,142,3,4,2,acept,4500,375,58,4933
Porto Alegre,110,3,3,2,acept,4000,300,59,4359
Sao Paulo,100,4,4,1,acept,10000,9,151,10160
Sao Paulo,377,5,4,3,acept,8000,900,121,9021
Sao Paulo,230,2,3,3,acept,8000,633,102,8735
Sao Paulo,35,1,1,0,not acept,1800,91,7,1898
Sao Paulo,32,1,1,1,acept,2900,0,37,2937
Sao Paulo,74,2,1,1,acept,2024,71,8,2103
Sao Paulo,147,2,3,4,acept,1200,375,16,1591
Sao Paulo,35,1,1,0,acept,2500,60,32,2592
Rio de Janeiro,26,1,1,0,acept,1500,84,20,1604
Sao Paulo,70,2,2,1,acept,1700,5,22,1727
Sao Paulo,150,3,3,3,acept,2800,740,36,3576
Sao Paulo,200,3,3,2,acept,8000,292,121,8413
Campinas,60,1,1,1,acept,1100,49,14,1163
Sao Paulo,250,4,5,3,acept,2550,334,33,2917
Sao Paulo,44,1,2,0,not acept,3300,126,42,3468
Sao Paulo,250,7,5,2,acept,6000,0,91,6091
Sao Paulo,157,3,2,0,acept,4500,347,58,4905
Sao Paulo,97,2,2,0,acept,5600,0,71,5671
Belo Horizonte,548,4,7,6,acept,15000,2484,200,17684
Sao Paulo,28,1,1,0,acept,1325,0,17,1342
Sao Paulo,250,3,4,0,acept,10000,1667,127,11794
Belo Horizonte,193,4,2,2,acept,8900,255,146,9301
Belo Horizonte,428,5,5,4,acept,9600,667,158,10425
Sao Paulo,50,2,1,0,not acept,950,0,13,963
Sao Paulo,135,2,3,2,not acept,12300,542,156,12998
Rio de Janeiro,103,2,2,1,acept,1600,221,21,1842
Campinas,103,3,2,2,acept,1360,292,18,1670
Sao Paulo,80,3,2,1,acept,1500,150,20,1670
Sao Paulo,160,3,3,2,acept,4000,390,51,4441
Sao Paulo,238,4,3,4,acept,10200,1816,130,12146
Belo Horizonte,500,7,4,4,acept,5500,167,91,5758
Sao Paulo,580,5,5,4,acept,15000,2200,191,17391
Sao Paulo,80,1,1,0,acept,1370,50,21,1441
Sao Paulo,210,4,5,3,acept,2975,1184,38,4197
Porto Alegre,106,3,3,1,acept,2250,186,33,2469
Rio de Janeiro,30,1,1,0,acept,1200,21,16,1237
Sao Paulo,156,3,2,1,acept,2000,147,31,2178
Sao Paulo,60,1,1,1,acept,1250,0,19,1269
Sao Paulo,200,3,4,0,acept,3600,780,46,4426
Sao Paulo,70,2,2,0,acept,1000,138,13,1151
Sao Paulo,177,4,5,4,acept,9200,959,117,10276
Sao Paulo,103,3,3,2,acept,2500,19,38,2557
Sao Paulo,440,4,4,4,acept,12000,2500,181,14681
Sao Paulo,65,2,1,1,acept,1700,92,22,1814
Belo Horizonte,260,5,3,3,acept,4000,487,54,4541
Sao Paulo,200,4,4,6,acept,4320,375,65,4760
Sao Paulo,96,3,2,1,acept,3050,231,39,3320
Sao Paulo,68,2,2,1,acept,2900,137,37,3074
Belo Horizonte,300,5,5,5,not acept,4500,450,74,5024
Sao Paulo,34,1,1,0,acept,750,27,10,787
Campinas,398,5,6,0,acept,8500,700,108,9308
Belo Horizonte,100,1,1,0,acept,2600,0,35,2635
Belo Horizonte,176,4,5,3,acept,6500,704,87,7291
Belo Horizonte,90,2,2,2,not acept,4000,250,54,4304
Belo Horizonte,680,7,6,8,acept,8000,428,132,8560
Belo Horizonte,220,4,3,0,acept,15000,1138,200,16338
Sao Paulo,110,2,2,2,not acept,2120,174,32,2326
Sao Paulo,180,3,2,1,acept,5500,255,70,5825
Sao Paulo,36,1,1,1,acept,1800,93,8,1901
Belo Horizonte,450,4,4,4,acept,12700,836,170,13706
Rio de Janeiro,103,3,2,0,acept,3300,336,43,3679
Porto Alegre,101,2,2,2,acept,1800,500,27,2327
Sao Paulo,196,4,4,0,acept,6000,1458,77,7535
Rio de Janeiro,28,1,1,0,acept,1980,68,26,2074
Sao Paulo,260,3,4,4,acept,4500,0,68,4568
Sao Paulo,330,4,2,5,acept,1870,400,29,2299
Rio de Janeiro,70,3,2,1,acept,1189,96,16,1301
Rio de Janeiro,33,1,1,0,acept,1200,13,16,1229
Sao Paulo,160,3,3,2,acept,10500,505,134,11139
Sao Paulo,60,2,1,1,acept,1350,42,18,1410
Sao Paulo,36,1,1,1,acept,1379,99,10,1488
Sao Paulo,20,1,1,0,acept,2060,0,27,2087
Porto Alegre,70,2,1,0,acept,750,26,11,787
Sao Paulo,180,3,4,4,acept,4700,2,71,4773
Sao Paulo,105,3,3,1,acept,2150,0,28,2178
Sao Paulo,275,4,5,4,acept,9700,1334,123,11157
Belo Horizonte,450,2,2,5,acept,1512,71,25,1608
Campinas,360,4,6,4,acept,7700,300,116,8116
Sao Paulo,140,2,2,1,not acept,1900,150,25,2075
Sao Paulo,900,3,5,8,acept,8000,2250,121,10371
Porto Alegre,152,3,5,3,acept,6000,321,88,6409
Sao Paulo,280,3,4,3,acept,8000,500,121,8621
Sao Paulo,230,4,4,3,not acept,2500,934,32,3466
Campinas,92,3,2,3,acept,2100,167,27,2294
Belo Horizonte,58,1,1,1,acept,1100,34,19,1153
Campinas,41,2,1,1,not acept,1193,0,16,1209
Sao Paulo,206,4,4,3,acept,12000,917,153,13070
Campinas,214,3,3,2,acept,5900,227,75,6202
Sao Paulo,110,2,2,1,acept,1710,0,22,1732
Belo Horizonte,100,2,1,0,acept,777,25,13,815
Belo Horizonte,80,2,2,1,acept,1200,0,16,1216
Belo Horizonte,311,3,4,3,not acept,13000,1753,174,14927
Sao Paulo,200,2,3,2,acept,15000,667,191,15858
Campinas,96,3,2,2,acept,3200,189,41,3430
Rio de Janeiro,140,4,2,1,not acept,6000,380,78,6458
Sao Paulo,138,3,3,2,acept,7070,382,90,7542
Sao Paulo,140,3,3,1,acept,3900,359,50,4309
Rio de Janeiro,60,2,2,1,not acept,1250,0,17,1267
Sao Paulo,40,1,1,0,not acept,600,34,10,644
Sao Paulo,178,3,4,4,acept,10200,667,130,10997
Sao Paulo,140,3,3,2,acept,4900,25,74,4999
Sao Paulo,72,2,1,0,acept,1020,0,13,1033
Sao Paulo,117,2,1,1,not acept,2700,11,35,2746
Sao Paulo,35,1,1,1,acept,977,30,13,1020
Porto Alegre,42,1,1,0,acept,890,0,13,903
Belo Horizonte,29,1,1,0,acept,1100,8,15,1123
Sao Paulo,130,2,1,0,acept,2150,9,28,2187
Rio de Janeiro,100,3,2,1,acept,5000,333,65,5398
Rio de Janeiro,39,1,1,0,acept,609,44,8,661
Sao Paulo,61,1,1,0,not acept,1600,0,21,1621
Campinas,750,4,5,5,not acept,10400,667,157,11224
Belo Horizonte,142,4,3,2,acept,2700,277,36,3013
Campinas,650,4,4,8,acept,7500,200,113,7813
Sao Paulo,69,2,2,0,acept,1700,73,26,1799
Sao Paulo,100,2,2,4,acept,2600,46,40,2686
Belo Horizonte,300,4,2,2,acept,8000,500,107,8607
Sao Paulo,190,3,4,3,acept,2740,900,35,3675
Rio de Janeiro,115,2,2,0,acept,4500,2731,58,7289
Campinas,119,3,1,1,acept,1200,100,16,1316
Sao Paulo,100,2,3,1,acept,1890,42,24,1956
Sao Paulo,55,2,1,1,acept,1087,0,14,1101
Sao Paulo,44,1,1,1,acept,3000,89,39,3128
Sao Paulo,316,4,6,4,acept,8000,1963,102,10065
Sao Paulo,83,2,3,2,acept,3500,167,53,3720
Belo Horizonte,1000,5,7,8,acept,14980,1904,246,17130
Sao Paulo,150,3,2,1,acept,4800,0,61,4861
Sao Paulo,53,2,1,1,acept,4200,42,54,4296
Sao Paulo,49,2,1,1,acept,970,4,13,987
Campinas,185,3,3,2,acept,2200,100,28,2328
Rio de Janeiro,40,1,1,0,acept,1200,20,19,1239
Sao Paulo,65,2,1,0,acept,1140,9,15,1164
Sao Paulo,67,3,2,1,not acept,1560,72,20,1652
Sao Paulo,46,1,1,1,acept,2200,35,28,2263
Campinas,205,3,2,1,acept,2200,156,28,2384
Porto Alegre,550,5,5,3,acept,9000,500,160,9660
Campinas,50,1,1,1,acept,650,33,9,692
Sao Paulo,266,4,5,4,acept,10900,1167,139,12206
Rio de Janeiro,280,3,2,2,acept,8000,1126,104,9230
Sao Paulo,1600,6,6,6,acept,7600,1834,115,9549
Sao Paulo,70,1,1,0,acept,2400,156,31,2587
Sao Paulo,84,3,2,2,not acept,2340,250,30,2620
Belo Horizonte,40,1,1,0,not acept,1000,116,14,1130
Rio de Janeiro,117,3,2,1,acept,4110,384,53,4547
Sao Paulo,68,2,2,2,acept,3430,236,44,3710
Belo Horizonte,140,2,2,2,acept,2800,104,38,2942
Sao Paulo,450,4,2,3,acept,13000,1000,196,14196
Porto Alegre,44,1,2,0,acept,1350,100,20,1470
Sao Paulo,40,1,1,1,acept,3200,52,41,3293
Sao Paulo,70,1,2,1,acept,8250,209,105,8564
Sao Paulo,50,1,2,0,acept,900,50,14,964
Belo Horizonte,405,2,3,0,acept,4000,699,54,4753
Sao Paulo,75,2,2,1,acept,3160,165,41,3366
Belo Horizonte,80,3,3,1,acept,1501,0,20,1521
Sao Paulo,450,4,5,6,acept,12000,1334,181,13515
Sao Paulo,225,4,5,4,acept,7106,0,91,7197
Sao Paulo,250,3,2,3,acept,15000,1084,191,16275
Sao Paulo,60,2,1,1,not acept,2200,165,28,2393
Sao Paulo,31,1,1,1,not acept,3400,150,44,3594
Sao Paulo,100,3,1,3,acept,2000,164,31,2195
Belo Horizonte,20,1,1,0,not acept,1050,79,14,1143
Sao Paulo,200,3,4,8,acept,7000,25,106,7131
Campinas,50,1,1,1,acept,1690,62,22,1774
Sao Paulo,61,3,2,2,acept,2200,90,28,2318
Sao Paulo,200,3,4,2,acept,9800,820,125,10745
Belo Horizonte,100,2,2,0,acept,11000,100,181,11281
Sao Paulo,365,4,5,6,acept,13900,2588,177,16665
Sao Paulo,38,1,1,0,acept,3000,64,39,3103
Rio de Janeiro,49,2,1,0,acept,1350,58,18,1426
Sao Paulo,207,3,5,4,acept,12000,934,153,13087
Campinas,82,3,2,1,acept,1500,142,20,1662
Sao Paulo,400,5,4,3,acept,4000,250,61,4311
Rio de Janeiro,170,4,2,2,acept,9000,834,116,9950
Porto Alegre,105,3,2,2,acept,2890,217,43,3150
Sao Paulo,383,4,4,5,acept,3004,709,39,3752
Sao Paulo,168,3,3,3,acept,2700,322,35,3057
Sao Paulo,53,2,2,1,acept,2400,389,31,2820
Porto Alegre,320,4,3,2,acept,4500,125,80,4705
Sao Paulo,300,3,4,3,acept,9900,834,126,10860
Campinas,100,3,2,3,acept,2200,0,34,2234
Sao Paulo,40,1,1,0,acept,900,80,12,992
Sao Paulo,180,3,1,0,acept,2500,334,38,2872
Sao Paulo,257,4,5,4,acept,7500,1107,96,8703
Sao Paulo,178,2,4,2,acept,7000,891,89,7980
Sao Paulo,179,3,3,0,not acept,12000,472,153,12625
Porto Alegre,64,2,1,0,acept,1750,42,26,1818
Porto Alegre,60,2,1,0,acept,990,25,15,1030
Sao Paulo,55,1,1,1,not acept,2200,148,28,2376
Sao Paulo,50,1,1,0,not acept,1970,0,25,1995
Sao Paulo,82,3,2,2,not acept,1994,0,26,2020
Rio de Janeiro,60,1,1,1,acept,1210,106,16,1332
Porto Alegre,40,1,1,1,not acept,1200,68,18,1286
Campinas,230,4,4,8,acept,5100,320,77,5497
Sao Paulo,73,2,1,1,acept,1300,20,17,1337
Sao Paulo,79,2,2,1,acept,2000,75,26,2101
Sao Paulo,230,3,4,2,acept,4800,292,61,5153
Rio de Janeiro,214,3,3,3,acept,14000,1050,181,15231
Sao Paulo,120,2,1,0,acept,1500,90,23,1613
Sao Paulo,200,4,2,1,not acept,2500,334,38,2872
Porto Alegre,85,3,2,2,not acept,3300,102,49,3451
Sao Paulo,45,1,1,1,not acept,5520,0,70,5590
Porto Alegre,30,1,1,0,acept,755,22,12,789
Sao Paulo,57,2,2,1,acept,2300,0,30,2330
Sao Paulo,500,4,7,3,acept,15000,2500,226,17726
Sao Paulo,322,4,5,5,acept,15000,1875,191,17066
Sao Paulo,20,1,1,0,not acept,1530,0,20,1550
Porto Alegre,100,2,2,1,not acept,1346,0,24,1370
Sao Paulo,620,4,6,4,acept,15000,4520,191,19711
Porto Alegre,240,4,3,5,acept,2500,120,45,2665
Sao Paulo,95,3,2,2,acept,7000,142,89,7231
Sao Paulo,35,1,1,1,acept,2100,99,27,2226
Belo Horizonte,325,5,4,7,acept,8900,417,146,9463
Sao Paulo,58,3,1,1,acept,2800,21,36,2857
Sao Paulo,200,4,4,3,not acept,9000,1000,115,10115
Sao Paulo,92,3,2,2,acept,1100,250,14,1364
Belo Horizonte,65,2,1,1,acept,1545,94,7,1646
Campinas,57,2,1,0,acept,800,31,11,842
Sao Paulo,50,2,1,1,acept,1600,0,21,1621
Sao Paulo,165,4,5,2,acept,9500,315,121,9936
Rio de Janeiro,70,2,1,1,acept,1900,122,25,2047
Sao Paulo,230,4,3,1,not acept,4000,513,51,4564
Rio de Janeiro,34,1,1,0,not acept,2000,114,26,2140
Rio de Janeiro,25,1,1,0,not acept,660,0,11,671
Sao Paulo,50,2,1,1,acept,1800,0,23,1823
Porto Alegre,120,3,2,2,acept,2975,155,44,3174
Porto Alegre,60,2,1,1,acept,1400,96,25,1521
Sao Paulo,67,2,2,1,acept,2240,215,29,2484
Sao Paulo,22,1,1,0,acept,2100,40,27,2167
Sao Paulo,197,3,1,2,acept,2100,290,32,2422
Porto Alegre,105,3,3,1,acept,2300,130,34,2464
Sao Paulo,80,2,2,1,not acept,1556,0,8,1564
Belo Horizonte,140,4,2,2,not acept,2500,253,34,2787
Rio de Janeiro,70,2,2,1,acept,4000,184,52,4236
Porto Alegre,383,5,5,4,acept,10000,250,178,10428
Sao Paulo,172,3,4,3,acept,9000,900,115,10015
Porto Alegre,57,2,2,1,not acept,1800,75,27,1902
Sao Paulo,32,1,1,1,acept,2000,416,26,2442
Belo Horizonte,341,10,6,7,acept,5500,459,91,6050
Belo Horizonte,600,5,6,8,acept,10500,642,173,11315
Sao Paulo,43,2,1,1,not acept,2000,18,26,2044
Campinas,98,3,2,1,acept,1233,84,16,1333
Sao Paulo,36,2,1,0,acept,1790,0,23,1813
Rio de Janeiro,42,1,1,0,acept,2800,79,37,2916
Campinas,120,3,3,3,not acept,2700,167,35,2902
Rio de Janeiro,78,2,2,1,acept,1400,290,19,1709
Sao Paulo,113,3,4,2,acept,4000,591,51,4642
Sao Paulo,47,2,1,1,not acept,1390,0,18,1408
Sao Paulo,60,2,2,1,acept,1300,0,17,1317
Porto Alegre,77,2,1,0,not acept,1130,25,17,1172
Porto Alegre,75,2,2,1,acept,1500,142,22,1664
Sao Paulo,60,3,1,1,acept,1550,0,20,1570
Sao Paulo,240,3,4,3,acept,5800,825,74,6699
Sao Paulo,48,1,1,1,acept,3400,114,44,3558
Belo Horizonte,70,3,1,1,acept,1300,71,18,1389
Belo Horizonte,345,3,3,0,not acept,3500,150,58,3708
Sao Paulo,250,4,2,3,not acept,15000,100,191,15291
Sao Paulo,158,4,4,3,acept,3500,589,45,4134
Porto Alegre,55,2,1,1,acept,1300,34,24,1358
Rio de Janeiro,80,2,1,1,acept,1820,235,24,2079
Porto Alegre,42,1,1,1,acept,2200,50,33,2283
Sao Paulo,80,3,3,2,acept,4450,242,57,4749
Sao Paulo,50,1,1,0,acept,1550,28,20,1598
Rio de Janeiro,380,4,3,2,acept,15000,1348,194,16542
Sao Paulo,85,2,2,1,acept,5300,67,68,5435
Belo Horizonte,120,4,3,2,acept,3250,0,44,3294
Sao Paulo,214,4,5,4,acept,3251,1026,42,4319
Sao Paulo,277,4,4,6,acept,3800,1947,49,5796
Campinas,50,2,1,1,acept,1080,0,14,1094
Belo Horizonte,90,3,2,2,not acept,2000,159,27,2186
Sao Paulo,287,4,5,2,acept,6000,317,91,6408
Sao Paulo,11,1,1,0,not acept,2000,42,26,2068
Porto Alegre,62,2,1,1,not acept,1620,54,24,1698
Sao Paulo,45,1,1,1,not acept,3100,120,40,3260
Porto Alegre,80,2,1,1,acept,1650,70,25,1745
Sao Paulo,115,3,3,2,not acept,4890,234,62,5186
Porto Alegre,110,2,2,1,acept,1800,152,27,1979
Sao Paulo,162,3,3,2,acept,7000,367,89,7456
Rio de Janeiro,85,3,2,1,acept,1800,306,24,2130
Belo Horizonte,105,4,3,3,acept,1900,228,26,2154
Sao Paulo,180,2,2,5,acept,3000,1,46,3047
Rio de Janeiro,80,2,1,0,acept,831,159,11,1001
Sao Paulo,56,2,1,1,acept,2200,11,28,2239
Sao Paulo,70,2,1,1,acept,1200,35,16,1251
Rio de Janeiro,70,1,2,1,not acept,1200,85,16,1301
Belo Horizonte,75,3,1,1,not acept,1000,145,14,1159
Sao Paulo,420,4,6,4,acept,6500,417,98,7015
Sao Paulo,279,3,3,8,acept,3500,182,53,3735
Sao Paulo,160,4,4,2,acept,2400,0,37,2437
Sao Paulo,41,1,1,0,acept,1100,0,14,1114
Sao Paulo,97,2,2,2,acept,2200,42,28,2270
Porto Alegre,40,1,1,1,acept,1400,36,21,1457
Sao Paulo,110,3,2,1,acept,3600,215,46,3861
Belo Horizonte,298,4,3,2,acept,2500,300,34,2834
Belo Horizonte,87,4,2,2,acept,1600,160,22,1782
Sao Paulo,150,5,5,4,not acept,3700,917,47,4664
Sao Paulo,113,3,2,2,acept,2975,359,38,3372
Belo Horizonte,293,6,2,3,acept,2600,138,43,2781
Sao Paulo,90,3,2,2,acept,2000,165,26,2191
Belo Horizonte,305,4,3,3,acept,9000,660,120,9780
Campinas,50,2,1,1,not acept,1040,277,14,1331
Sao Paulo,150,3,3,2,acept,3300,135,50,3485
Porto Alegre,367,3,4,4,not acept,15000,1032,220,16252
Rio de Janeiro,50,2,1,0,acept,2350,64,31,2445
Sao Paulo,230,3,4,3,not acept,8000,1167,102,9269
Sao Paulo,125,3,3,1,acept,5500,247,70,5817
Rio de Janeiro,140,3,2,1,acept,1350,95,18,1463
Sao Paulo,63,3,2,0,acept,1800,0,23,1823
Sao Paulo,110,2,1,1,acept,3300,234,42,3576
Sao Paulo,54,2,1,1,acept,1610,0,21,1631
Porto Alegre,67,2,1,0,acept,1523,50,23,1596
Sao Paulo,296,3,4,4,acept,8864,0,113,8977
Belo Horizonte,70,2,1,1,acept,1000,75,17,1092
Sao Paulo,50,2,1,0,not acept,1100,0,17,1117
Sao Paulo,160,3,2,4,not acept,3500,0,53,3553
Sao Paulo,60,2,2,1,not acept,2200,20,28,2248
Sao Paulo,220,3,4,3,acept,8000,1034,102,9136
Sao Paulo,340,4,3,8,acept,13000,1167,196,14363
Sao Paulo,52,2,1,0,not acept,1150,34,15,1199
Belo Horizonte,50,2,1,1,acept,915,63,13,991
Belo Horizonte,60,2,1,0,acept,2200,80,30,2310
Sao Paulo,125,3,3,3,acept,2450,15,37,2502
Sao Paulo,36,2,1,0,not acept,1080,0,17,1097
Belo Horizonte,100,3,2,1,acept,1500,120,20,1640
Sao Paulo,550,4,7,3,acept,11500,1650,173,13323
Sao Paulo,60,3,1,2,not acept,1105,0,14,1119
Campinas,48,1,1,0,not acept,500,17,7,524
Sao Paulo,164,3,3,1,acept,9000,210,115,9325
Belo Horizonte,90,3,2,1,acept,1200,100,16,1316
Porto Alegre,78,3,2,1,acept,2800,75,41,2916
Sao Paulo,44,2,1,0,acept,1125,0,15,1140
Belo Horizonte,180,3,3,2,acept,2950,267,40,3257
Campinas,82,3,2,1,acept,1200,100,16,1316
Sao Paulo,49,1,1,1,acept,2900,139,37,3076
Sao Paulo,400,5,4,5,not acept,13970,417,210,14597
Sao Paulo,74,2,3,2,acept,3200,40,41,3281
Sao Paulo,110,2,1,1,acept,1500,163,23,1686
Sao Paulo,58,1,1,1,acept,3500,70,45,3615
Rio de Janeiro,23,1,1,0,not acept,1540,0,20,1560
Rio de Janeiro,95,3,2,1,acept,2500,67,33,2600
Sao Paulo,196,4,3,3,not acept,5000,931,64,5995
Sao Paulo,70,2,1,0,acept,2300,123,35,2458
Porto Alegre,148,2,1,2,acept,1650,880,25,2555
Sao Paulo,70,2,1,0,acept,1280,0,17,1297
Sao Paulo,30,1,1,1,not acept,2300,134,30,2464
Sao Paulo,300,3,2,4,acept,2700,250,41,2991
Sao Paulo,53,1,1,1,not acept,2600,0,33,2633
Sao Paulo,96,3,2,2,acept,3148,81,40,3269
Sao Paulo,190,3,4,2,not acept,6000,48,77,6125
Sao Paulo,250,3,5,8,acept,6000,7,91,6098
Belo Horizonte,130,4,1,3,not acept,2150,0,36,2186
Sao Paulo,250,3,3,6,acept,4250,519,64,4833
Campinas,50,1,1,0,acept,650,13,9,672
Belo Horizonte,840,5,6,5,acept,8000,511,132,8643
Rio de Janeiro,95,3,3,0,acept,1999,291,26,2316
Sao Paulo,33,1,1,0,not acept,1305,0,17,1322
Rio de Janeiro,60,2,1,0,acept,1350,0,18,1368
Sao Paulo,51,1,1,0,acept,4950,125,63,5138
Rio de Janeiro,200,4,3,2,acept,8000,756,104,8860
Sao Paulo,212,4,5,6,acept,4500,1067,58,5625
Belo Horizonte,66,3,1,0,acept,1525,0,26,1551
Sao Paulo,150,3,5,2,acept,3102,452,40,3594
Rio de Janeiro,48,2,1,1,acept,1270,9,17,1296
Sao Paulo,90,2,2,1,acept,2500,274,38,2812
Porto Alegre,136,4,3,2,not acept,4000,327,59,4386
Sao Paulo,40,1,1,1,acept,3000,95,39,3134
Sao Paulo,100,1,2,2,not acept,1700,0,26,1726
Sao Paulo,32,1,1,0,acept,1200,100,16,1316
Sao Paulo,30,1,1,1,acept,3300,9,42,3351
Sao Paulo,170,2,2,5,acept,5500,600,83,6183
Campinas,184,4,3,4,acept,3240,220,49,3509
Sao Paulo,368,4,5,4,acept,5000,2661,64,7725
Sao Paulo,230,3,4,4,acept,7000,917,89,8006
Sao Paulo,214,4,6,4,acept,11000,780,140,11920
Belo Horizonte,37,1,1,1,not acept,2000,0,27,2027
Sao Paulo,450,5,5,4,not acept,5540,520,84,6144
Sao Paulo,87,3,2,0,acept,2000,231,26,2257
Sao Paulo,70,2,1,1,acept,1300,25,20,1345
Sao Paulo,54,2,1,1,acept,1250,7,16,1273
Belo Horizonte,155,4,3,3,acept,3300,356,44,3700
Sao Paulo,35,1,1,0,acept,1100,30,14,1144
Sao Paulo,160,4,4,5,acept,4500,0,68,4568
Belo Horizonte,95,3,2,2,acept,1400,122,19,1541
Sao Paulo,113,2,1,1,acept,3000,50,39,3089
Rio de Janeiro,70,3,2,1,acept,850,255,11,1116
Sao Paulo,131,3,2,2,acept,1800,600,23,2423
Belo Horizonte,130,3,3,1,acept,3200,150,43,3393
Porto Alegre,72,2,1,0,acept,1300,40,19,1359
Belo Horizonte,130,2,1,1,acept,1280,59,21,1360
Rio de Janeiro,80,2,3,1,acept,1300,320,10,1630
Sao Paulo,50,3,2,2,acept,2800,30,43,2873
Sao Paulo,54,2,1,1,not acept,2000,10,26,2036
Sao Paulo,130,3,3,3,acept,2800,489,36,3325
Porto Alegre,230,4,1,1,acept,3500,370,52,3922
Sao Paulo,50,2,1,1,acept,1100,0,14,1114
Belo Horizonte,100,3,2,3,acept,2800,0,46,2846
Belo Horizonte,40,1,1,1,not acept,970,0,13,983
Campinas,75,3,1,1,not acept,12000,0,181,12181
Sao Paulo,30,1,1,1,not acept,1200,144,16,1360
Porto Alegre,68,2,2,1,acept,1800,82,27,1909
Sao Paulo,117,3,3,2,acept,2700,16,41,2757
Porto Alegre,600,5,4,5,acept,12000,1167,214,13381
Sao Paulo,126,3,2,2,not acept,1610,0,21,1631
Porto Alegre,290,4,4,3,acept,2500,262,45,2807
Porto Alegre,120,3,1,0,acept,1500,125,22,1647
Rio de Janeiro,35,1,1,0,acept,1600,0,21,1621
Belo Horizonte,40,1,1,1,not acept,970,0,13,983
Sao Paulo,56,2,2,1,acept,2000,0,26,2026
Campinas,53,2,1,1,acept,800,65,11,876
Sao Paulo,270,4,4,4,acept,15000,100,191,15291
Porto Alegre,150,4,2,2,acept,1100,0,20,1120
Sao Paulo,40,1,1,0,not acept,980,0,13,993
Sao Paulo,31,1,1,0,acept,3280,109,42,3431
Sao Paulo,50,2,2,1,acept,1275,23,17,1315
Sao Paulo,347,5,5,4,acept,7000,500,106,7606
Sao Paulo,70,3,1,1,not acept,1800,42,23,1865
Rio de Janeiro,75,2,1,0,acept,1200,0,16,1216
Porto Alegre,90,3,2,0,not acept,1105,31,17,1153
Sao Paulo,200,3,4,1,acept,1190,550,16,1756
Sao Paulo,201,4,4,4,acept,5933,900,76,6909
Sao Paulo,37,1,1,0,acept,1400,0,18,1418
Sao Paulo,75,3,1,1,not acept,2200,70,28,2298
Sao Paulo,42,1,1,0,acept,1650,184,21,1855
Campinas,148,3,2,0,acept,1700,102,22,1824
Sao Paulo,200,2,2,0,acept,3000,9,46,3055
Sao Paulo,216,3,3,3,acept,13000,1230,165,14395
Sao Paulo,300,3,2,0,acept,8300,217,125,8642
Sao Paulo,73,1,1,0,acept,1350,62,18,1430
Rio de Janeiro,77,3,1,0,acept,4200,269,55,4524
Belo Horizonte,50,2,1,0,acept,850,30,12,892
Sao Paulo,480,4,7,8,acept,14000,2186,211,16397
Sao Paulo,300,5,5,2,acept,4000,220,61,4281
Rio de Janeiro,180,3,2,1,acept,4900,459,64,5423
Porto Alegre,68,3,2,1,acept,1600,76,24,1700
Sao Paulo,62,2,2,1,acept,1550,17,20,1587
Sao Paulo,62,2,2,2,not acept,3230,230,41,3501
Campinas,212,4,1,2,acept,1500,88,23,1611
Sao Paulo,340,3,4,4,acept,10000,1584,151,11735
Porto Alegre,280,5,4,8,acept,10000,417,178,10595
Sao Paulo,250,4,3,4,acept,7200,434,109,7743
Sao Paulo,64,2,1,0,acept,1600,100,21,1721
Sao Paulo,25,1,1,0,acept,2100,41,27,2168
Sao Paulo,37,1,1,0,not acept,3250,69,42,3361
Campinas,51,3,1,1,acept,1100,71,14,1185
Rio de Janeiro,75,2,3,1,acept,1600,260,21,1881
Sao Paulo,40,1,1,1,not acept,972,0,15,987
Rio de Janeiro,25,1,1,0,acept,700,0,10,710
Porto Alegre,340,5,4,4,acept,4800,300,86,5186
Rio de Janeiro,60,2,1,0,acept,2650,209,35,2894
Campinas,90,1,1,1,not acept,1680,100,22,1802
Sao Paulo,120,3,3,2,acept,8900,371,134,9405
Sao Paulo,200,1,2,0,acept,8000,700,121,8821
Sao Paulo,168,4,4,3,acept,3250,234,42,3526
Sao Paulo,212,4,5,4,acept,10000,834,127,10961
Sao Paulo,40,1,1,1,acept,2400,0,31,2431
Sao Paulo,78,1,2,1,not acept,2440,167,31,2638
Sao Paulo,340,3,4,3,acept,9800,392,148,10340
Belo Horizonte,300,4,4,4,acept,10000,1114,134,11248
Belo Horizonte,181,3,3,3,acept,5500,148,91,5739
Sao Paulo,68,2,2,0,not acept,6443,20,82,6545
Sao Paulo,600,6,7,4,acept,15000,84,226,15310
Sao Paulo,138,3,3,2,acept,2700,141,41,2882
Belo Horizonte,65,2,1,1,not acept,1200,101,16,1317
Sao Paulo,44,1,1,1,not acept,2000,130,26,2156
Sao Paulo,600,5,7,8,acept,9000,1875,136,11011
Belo Horizonte,53,1,1,0,acept,1300,89,18,1407
Belo Horizonte,340,4,5,4,acept,12000,872,160,13032
Sao Paulo,183,6,5,2,not acept,3800,25,58,3883
Sao Paulo,80,2,3,0,acept,3300,427,42,3769
Campinas,50,1,1,1,not acept,2800,123,36,2959
Sao Paulo,293,4,3,3,acept,1050,500,14,1564
Belo Horizonte,80,3,2,1,acept,1800,124,24,1948
Sao Paulo,30,1,1,0,acept,1318,0,17,1335
Sao Paulo,150,3,4,2,acept,2000,200,31,2231
Campinas,70,3,2,2,acept,2010,74,26,2110
Sao Paulo,85,2,1,1,acept,2300,97,30,2427
Rio de Janeiro,500,5,5,1,acept,7900,486,121,8507
Porto Alegre,49,2,1,1,acept,1220,6,22,1248
Sao Paulo,325,4,5,7,acept,11500,825,173,12498
Rio de Janeiro,35,1,1,0,not acept,2570,58,34,2662
Sao Paulo,270,4,3,3,acept,7500,550,96,8146
Sao Paulo,540,4,7,5,acept,15000,3565,191,18756
Sao Paulo,150,3,5,3,acept,11000,284,140,11424
Belo Horizonte,300,3,3,2,acept,5000,690,82,5772
Sao Paulo,42,1,1,1,not acept,2500,202,32,2734
Sao Paulo,126,2,1,0,acept,1700,314,26,2040
Sao Paulo,67,2,1,1,acept,2099,250,27,2376
Sao Paulo,80,3,3,2,acept,2000,283,26,2309
Sao Paulo,85,3,1,2,acept,1900,139,25,2064
Porto Alegre,290,5,5,3,not acept,5600,49,82,5731
Sao Paulo,274,2,3,4,acept,3000,323,46,3369
Campinas,46,2,1,1,acept,970,42,13,1025
Belo Horizonte,50,2,1,1,acept,860,69,12,941
Sao Paulo,42,1,1,0,not acept,1600,50,25,1675
Campinas,55,1,1,1,acept,1195,0,16,1211
Rio de Janeiro,55,1,2,1,acept,1200,55,16,1271
Belo Horizonte,80,2,3,2,acept,3260,350,44,3654
Sao Paulo,42,1,1,1,acept,2300,95,30,2425
Campinas,70,2,1,1,acept,1275,74,17,1366
Campinas,78,3,2,1,acept,1935,73,25,2033
Belo Horizonte,55,2,1,1,acept,1100,91,15,1206
Sao Paulo,63,2,1,1,acept,1120,34,15,1169
Sao Paulo,57,2,2,1,acept,2550,132,33,2715
Porto Alegre,78,2,1,0,acept,1330,91,20,1441
Sao Paulo,140,2,2,2,acept,6740,0,86,6826
Belo Horizonte,71,3,2,2,acept,1300,101,18,1419
Sao Paulo,845,5,9,6,acept,8499,1000,128,9627
Belo Horizonte,70,2,1,1,not acept,1100,107,15,1222
Campinas,40,1,1,0,not acept,595,12,8,615
Sao Paulo,82,2,2,1,acept,3100,51,40,3191
Sao Paulo,31,1,1,1,acept,3200,64,41,3305
Porto Alegre,62,2,2,1,not acept,3900,100,57,4057
Sao Paulo,156,4,4,3,acept,3510,995,45,4550
Sao Paulo,300,3,4,7,not acept,4340,550,66,4956
Rio de Janeiro,35,1,1,0,acept,750,0,10,760
Sao Paulo,40,1,1,1,not acept,1600,160,21,1781
Sao Paulo,39,1,1,1,acept,1700,50,22,1772
Belo Horizonte,100,3,3,2,not acept,1800,143,24,1967
Rio de Janeiro,60,2,1,0,acept,1100,86,15,1201
Sao Paulo,43,2,1,0,not acept,1250,120,16,1386
Rio de Janeiro,120,2,2,0,acept,12000,125,155,12280
Belo Horizonte,90,3,1,1,acept,1360,1,23,1384
Sao Paulo,170,3,2,1,acept,10500,84,134,10718
Belo Horizonte,154,4,2,3,not acept,5400,647,72,6119
Sao Paulo,108,3,3,2,acept,4800,393,61,5254
Sao Paulo,20,1,1,0,acept,1800,130,23,1953
Rio de Janeiro,200,4,3,2,acept,2300,467,30,2797
Belo Horizonte,800,7,7,4,acept,8900,943,146,9989
Sao Paulo,43,2,2,0,not acept,1750,70,23,1843
Campinas,125,2,1,0,acept,850,120,11,981
Campinas,28,1,1,0,not acept,1390,0,18,1408
Sao Paulo,37,1,1,1,not acept,2600,252,33,2885
Sao Paulo,60,3,2,1,acept,2430,0,37,2467
Sao Paulo,121,2,3,1,acept,2560,170,33,2763
Belo Horizonte,600,5,5,2,acept,7500,158,123,7781
Sao Paulo,161,3,3,2,acept,2750,418,35,3203
Campinas,60,2,1,1,acept,1350,67,18,1435
Sao Paulo,60,3,1,1,acept,1700,8,22,1730
Rio de Janeiro,55,2,1,0,acept,2300,109,30,2439
Sao Paulo,90,3,1,1,acept,3000,50,39,3089
Sao Paulo,65,2,1,0,acept,1500,84,23,1607
Porto Alegre,18,1,1,0,acept,700,15,11,726
Sao Paulo,345,3,3,5,acept,12750,834,162,13746
Porto Alegre,50,2,1,1,acept,1190,42,18,1250
Sao Paulo,230,4,5,4,acept,12500,917,159,13576
Sao Paulo,100,2,2,1,acept,1850,60,24,1934
Sao Paulo,136,3,3,3,acept,4206,364,54,4624
Porto Alegre,263,3,3,0,acept,3500,150,52,3702
Belo Horizonte,65,2,2,2,acept,1700,115,23,1838
Belo Horizonte,166,2,2,2,not acept,2100,253,28,2381
Sao Paulo,20,1,1,0,acept,1800,130,23,1953
Campinas,308,4,3,4,acept,3900,381,59,4340
Sao Paulo,400,4,3,5,acept,10600,459,160,11219
Belo Horizonte,140,3,4,3,acept,3000,307,40,3347
Campinas,47,1,1,0,acept,550,14,7,571
Sao Paulo,178,3,3,3,acept,8300,700,106,9106
Belo Horizonte,100,3,2,1,acept,1500,60,20,1580
Sao Paulo,62,3,2,1,not acept,4800,167,61,5028
Sao Paulo,390,4,4,5,not acept,8600,3917,109,12626
Sao Paulo,217,3,4,1,acept,9000,458,115,9573
Belo Horizonte,280,4,4,3,acept,9000,503,120,9623
Sao Paulo,30,1,1,1,not acept,2500,62,32,2594
Sao Paulo,39,1,1,1,acept,2500,0,32,2532
Belo Horizonte,118,3,3,1,acept,1230,88,17,1335
Sao Paulo,42,1,1,1,not acept,1900,150,25,2075
Sao Paulo,120,2,3,2,acept,9920,0,126,10046
Sao Paulo,174,4,5,4,acept,4745,567,61,5373
Sao Paulo,450,4,4,3,acept,10000,0,127,10127
Belo Horizonte,50,2,1,1,acept,900,69,12,981
Sao Paulo,50,2,2,2,acept,7070,0,90,7160
Rio de Janeiro,80,2,1,0,acept,2000,76,26,2102
Porto Alegre,134,3,2,2,acept,2900,242,43,3185
Campinas,188,5,4,0,acept,4000,178,61,4239
Rio de Janeiro,90,2,2,2,acept,4850,200,63,5113
Sao Paulo,340,4,4,3,not acept,5000,1084,64,6148
Sao Paulo,110,3,3,2,acept,2800,77,43,2920
Rio de Janeiro,58,2,1,1,acept,2673,0,35,2708
Rio de Janeiro,37,1,1,0,acept,1840,86,24,1950
Sao Paulo,280,3,5,3,acept,8000,0,121,8121
Sao Paulo,220,3,4,3,acept,8000,555,102,8657
Sao Paulo,272,5,5,2,acept,11000,917,166,12083
Sao Paulo,49,2,1,1,acept,2000,80,26,2106
Campinas,54,1,1,1,acept,773,67,10,850
Belo Horizonte,68,2,1,1,acept,500,30,7,537
Sao Paulo,227,3,4,4,not acept,12000,1292,153,13445
Belo Horizonte,350,5,4,4,acept,15000,1320,246,16566
Porto Alegre,116,3,2,1,acept,2600,167,38,2805
Sao Paulo,130,2,2,1,acept,5600,75,71,5746
Sao Paulo,94,2,2,1,acept,3500,92,45,3637
Sao Paulo,330,5,4,4,acept,4600,192,70,4862
Rio de Janeiro,230,4,4,0,acept,11000,900,142,12042
Belo Horizonte,55,2,1,1,not acept,900,0,12,912
Sao Paulo,148,3,2,3,acept,3300,609,42,3951
Sao Paulo,500,3,3,7,acept,5500,84,83,5667
Campinas,184,4,3,4,acept,3240,220,49,3509
Rio de Janeiro,250,4,4,0,acept,5000,575,65,5640
Belo Horizonte,306,3,5,0,acept,8000,0,132,8132
Belo Horizonte,20,1,1,0,acept,1050,79,14,1143
Porto Alegre,60,1,1,0,not acept,920,0,14,934
Sao Paulo,130,3,2,2,not acept,6200,4000,79,10279
Sao Paulo,450,4,5,7,acept,12000,334,181,12515
Rio de Janeiro,113,3,1,0,not acept,2500,130,33,2663
Rio de Janeiro,66,2,1,1,not acept,1170,67,16,1253
Campinas,83,2,1,1,not acept,960,50,13,1023
Belo Horizonte,83,3,3,2,acept,3655,142,49,3846
Sao Paulo,50,1,1,1,not acept,4600,305,59,4964
Sao Paulo,52,2,1,1,acept,3350,0,43,3393
Sao Paulo,250,3,3,3,acept,3210,0,49,3259
Sao Paulo,121,2,2,1,acept,3100,292,40,3432
Rio de Janeiro,85,2,3,1,acept,7100,194,92,7386
Sao Paulo,152,4,3,3,not acept,4700,823,60,5583
Sao Paulo,32,1,1,1,not acept,1700,125,22,1847
Sao Paulo,311,4,5,6,acept,14000,3461,178,17639
Sao Paulo,97,3,2,2,acept,3000,303,39,3342
Sao Paulo,250,4,5,4,acept,8440,1200,107,9747
Rio de Janeiro,32,1,1,0,acept,1400,66,19,1485
Sao Paulo,360,4,9,8,acept,8540,1329,129,9998
Sao Paulo,24,1,1,0,not acept,870,0,14,884
Sao Paulo,55,1,1,1,acept,3190,309,41,3540
Belo Horizonte,83,3,2,2,acept,1250,112,17,1379
Sao Paulo,87,3,2,2,not acept,2600,234,33,2867
Campinas,64,2,1,1,acept,850,76,11,937
Sao Paulo,25,1,1,0,not acept,1350,87,21,1458
Sao Paulo,30,1,1,1,acept,2001,125,26,2152
Rio de Janeiro,500,2,5,5,not acept,1810,54,28,1892
Porto Alegre,75,2,2,2,acept,2750,92,41,2883
Sao Paulo,205,3,3,4,acept,6500,667,98,7265
Belo Horizonte,88,3,2,0,acept,1200,295,20,1515
Porto Alegre,60,3,2,1,acept,1800,80,27,1907
Belo Horizonte,70,2,1,1,acept,1100,60,15,1175
Rio de Janeiro,100,2,3,0,acept,1700,130,22,1852
Porto Alegre,37,1,1,0,acept,628,13,10,651
Sao Paulo,45,1,1,0,not acept,1050,34,16,1100
Sao Paulo,330,3,3,5,acept,8500,1201,128,9829
Sao Paulo,35,1,1,0,not acept,2800,200,36,3036
Belo Horizonte,144,3,1,2,acept,2300,170,31,2501
Belo Horizonte,70,3,2,1,acept,1200,69,16,1285
Sao Paulo,68,2,2,1,acept,2083,154,27,2264
Sao Paulo,101,3,2,2,not acept,5250,316,67,5633
Sao Paulo,33,1,1,1,acept,2000,95,26,2121
Sao Paulo,200,4,2,2,acept,5800,250,88,6138
Sao Paulo,80,2,1,0,acept,1439,52,22,1513
Sao Paulo,74,2,1,0,not acept,1290,34,20,1344
Belo Horizonte,65,2,2,1,acept,1500,76,20,1596
Campinas,111,3,3,3,not acept,5000,283,64,5347
Sao Paulo,380,3,6,8,acept,9000,244,136,9380
Sao Paulo,60,2,1,0,acept,1720,90,26,1836
Sao Paulo,300,3,3,5,acept,4250,417,64,4731
Porto Alegre,72,2,2,2,acept,2400,88,36,2524
Rio de Janeiro,75,2,2,1,not acept,2750,263,36,3049
Sao Paulo,70,2,1,2,acept,1400,156,18,1574
Belo Horizonte,360,5,4,1,acept,4600,158,76,4834
Sao Paulo,23,1,1,0,acept,1580,0,21,1601
Sao Paulo,100,3,2,2,not acept,3500,227,45,3772
Sao Paulo,150,4,4,3,acept,4100,172,62,4334
Rio de Janeiro,57,1,1,1,acept,2480,800,32,3312
Sao Paulo,180,3,2,2,acept,3270,188,50,3508
Belo Horizonte,360,3,3,4,acept,5000,454,82,5536
Sao Paulo,120,3,3,2,acept,2200,100,28,2328
Belo Horizonte,45,2,1,1,not acept,900,0,12,912
Rio de Janeiro,30,1,1,0,acept,900,94,12,1006
Sao Paulo,40,1,1,1,not acept,3000,248,39,3287
Sao Paulo,130,3,2,1,not acept,4500,384,58,4942
Campinas,68,2,1,1,acept,831,0,11,842
Sao Paulo,70,2,1,1,acept,1000,138,13,1151
Rio de Janeiro,77,2,2,1,acept,3000,230,39,3269
Sao Paulo,220,4,4,1,acept,5500,650,70,6220
Campinas,55,1,1,1,acept,720,80,10,810
Porto Alegre,70,3,1,1,acept,1300,36,19,1355
Sao Paulo,250,4,4,4,acept,12000,1120,153,13273
Sao Paulo,110,3,2,2,acept,5550,385,71,6006
Campinas,151,2,2,1,acept,2000,262,26,2288
Campinas,45,1,1,0,acept,700,10,9,719
Belo Horizonte,40,1,1,1,acept,2600,272,35,2907
Belo Horizonte,98,3,2,2,acept,1100,82,15,1197
Sao Paulo,70,2,2,1,acept,1000,138,13,1151
Sao Paulo,205,4,3,3,acept,10000,1167,127,11294
Sao Paulo,40,1,1,1,not acept,1080,65,14,1159
Sao Paulo,100,3,2,1,acept,3600,325,46,3971
Belo Horizonte,55,2,1,1,acept,1200,83,16,1299
Sao Paulo,288,3,3,3,acept,12000,878,181,13059
Rio de Janeiro,70,1,1,0,not acept,3400,77,44,3521
Sao Paulo,70,2,1,1,not acept,2000,0,26,2026
Sao Paulo,100,2,2,2,acept,2780,109,36,2925
Porto Alegre,72,2,1,0,acept,1600,54,24,1678
Rio de Janeiro,20,1,1,0,acept,980,20,13,1013
Porto Alegre,360,4,4,4,not acept,2820,321,51,3192
Sao Paulo,150,3,3,2,acept,4680,235,71,4986
Sao Paulo,130,3,4,0,acept,2443,0,31,2474
Sao Paulo,22,1,1,0,acept,2100,40,27,2167
Campinas,53,1,1,1,acept,3110,85,40,3235
Rio de Janeiro,53,2,1,0,not acept,1000,0,13,1013
Sao Paulo,642,4,7,4,acept,9050,250,137,9437
Sao Paulo,240,4,5,5,acept,9900,1529,126,11555
Sao Paulo,450,3,3,1,acept,6500,59,98,6657
Campinas,57,2,1,1,not acept,850,67,11,928
Belo Horizonte,130,4,3,1,acept,2600,206,35,2841
Sao Paulo,53,2,2,1,acept,2350,0,30,2380
Porto Alegre,39,1,1,1,not acept,2600,67,38,2705
Sao Paulo,850,6,7,4,not acept,13000,2465,196,15661
Sao Paulo,35,1,1,0,not acept,1305,0,17,1322
Sao Paulo,67,1,1,0,acept,1300,55,20,1375
Sao Paulo,120,3,2,1,acept,2600,120,33,2753
Sao Paulo,200,5,6,4,acept,5000,1250,64,6314
Belo Horizonte,69,3,1,2,acept,1300,0,18,1318
Porto Alegre,60,2,1,1,acept,540,0,10,550
Belo Horizonte,30,1,1,1,acept,890,30,12,932
Rio de Janeiro,30,1,1,0,acept,1200,21,16,1237
Campinas,650,4,6,4,acept,13000,1042,196,14238
Porto Alegre,80,2,1,1,not acept,1500,250,22,1772
Sao Paulo,35,1,1,1,acept,977,30,13,1020
Rio de Janeiro,135,3,2,1,acept,4100,517,53,4670
Sao Paulo,60,2,1,0,acept,1800,0,23,1823
Belo Horizonte,80,2,2,1,acept,1070,100,15,1185
Campinas,80,2,2,1,acept,1500,41,23,1564
Belo Horizonte,160,4,6,3,not acept,4750,831,64,5645
Sao Paulo,135,2,2,1,acept,8700,343,111,9154
Campinas,340,4,5,0,not acept,4000,334,61,4395
Sao Paulo,35,1,1,1,not acept,3507,124,45,3676
Porto Alegre,38,1,1,0,not acept,806,92,12,910
Porto Alegre,81,3,2,1,acept,1630,90,24,1744
Belo Horizonte,150,3,3,3,acept,5950,146,98,6194
Sao Paulo,126,3,1,2,acept,4200,299,64,4563
Sao Paulo,71,1,1,0,acept,1443,0,5,1448
Sao Paulo,20,1,1,0,acept,1800,130,23,1953
Campinas,55,1,1,1,not acept,750,80,10,840
Campinas,76,2,2,2,acept,2800,152,36,2988
Rio de Janeiro,40,1,1,0,acept,2800,100,37,2937
Sao Paulo,400,3,5,5,acept,12500,0,188,12688
Belo Horizonte,70,3,1,2,acept,1000,0,14,1014
Sao Paulo,38,1,1,1,acept,2800,10,36,2846
Rio de Janeiro,80,2,1,0,acept,1500,125,20,1645
Rio de Janeiro,64,1,1,0,acept,1200,105,16,1321
Belo Horizonte,300,4,3,2,acept,10000,695,164,10859
Sao Paulo,71,3,4,0,acept,4000,0,61,4061
Sao Paulo,25,1,1,1,not acept,3500,92,45,3637
Sao Paulo,1000,4,7,4,acept,15000,4900,191,20091
Sao Paulo,196,3,5,3,acept,8440,1223,60,9723
Campinas,48,2,1,1,acept,1190,0,16,1206
Sao Paulo,315,3,5,2,not acept,20000,959,254,21213
Belo Horizonte,184,3,1,2,acept,4000,110,54,4164
Porto Alegre,450,5,4,4,acept,9000,250,160,9410
Sao Paulo,102,3,2,2,acept,2000,284,26,2310
Campinas,135,3,2,2,acept,2040,92,26,2158
Sao Paulo,41,1,1,1,not acept,3000,36,39,3075
Sao Paulo,144,2,4,6,acept,2196,225,34,2455
Rio de Janeiro,110,3,3,1,not acept,1000,100,13,1113
Porto Alegre,43,1,1,1,acept,1870,0,28,1898
Sao Paulo,450,4,5,2,not acept,15000,1400,226,16626
Belo Horizonte,70,2,1,2,acept,1600,100,22,1722
Sao Paulo,220,4,4,4,not acept,3230,1576,41,4847
Sao Paulo,52,1,2,1,acept,5000,210,64,5274
Sao Paulo,198,2,2,2,acept,5500,320,70,5890
Sao Paulo,30,2,1,0,acept,1500,5,23,1528
Rio de Janeiro,217,3,3,2,acept,10300,600,133,11033
Sao Paulo,290,4,4,0,acept,6800,1100,103,8003
Porto Alegre,70,2,1,0,acept,1450,120,22,1592
Rio de Janeiro,45,1,1,0,not acept,2500,84,33,2617
Sao Paulo,40,1,1,1,not acept,1675,50,22,1747
Campinas,180,4,3,2,acept,4348,167,66,4581
Rio de Janeiro,90,2,1,0,acept,1200,142,16,1358
Sao Paulo,26,1,1,0,not acept,1178,28,15,1221
Sao Paulo,629,4,4,4,acept,15000,2064,226,17290
Sao Paulo,120,4,3,2,acept,3000,67,46,3113
Porto Alegre,49,1,1,0,not acept,600,15,9,624
Sao Paulo,44,2,1,1,acept,1250,0,16,1266
Sao Paulo,427,4,6,4,acept,10000,1350,127,11477
Sao Paulo,286,4,5,4,acept,4000,1580,51,5631
Porto Alegre,88,2,2,2,acept,1600,84,24,1708
Sao Paulo,120,2,3,2,acept,7000,180,89,7269
Sao Paulo,74,1,2,2,acept,3560,285,46,3891
Porto Alegre,350,3,4,4,not acept,3500,167,63,3730
Porto Alegre,80,2,2,1,acept,1600,92,24,1716
Sao Paulo,63,2,2,1,acept,4300,136,55,4491
Sao Paulo,22,1,1,0,acept,1600,0,21,1621
Sao Paulo,94,2,3,0,acept,1300,306,17,1623
Sao Paulo,60,2,1,0,acept,1600,25,25,1650
Rio de Janeiro,190,4,4,0,acept,4000,600,52,4652
Sao Paulo,78,2,1,1,acept,2500,0,32,2532
Belo Horizonte,300,5,4,4,acept,9000,1461,148,10609
Sao Paulo,211,4,4,4,not acept,2880,717,37,3634
Campinas,84,2,1,1,acept,1100,104,14,1218
Porto Alegre,300,3,3,5,acept,3825,89,68,3982
Belo Horizonte,497,5,5,4,not acept,8000,720,132,8852
Sao Paulo,71,3,2,1,acept,2500,130,32,2662
Rio de Janeiro,138,2,1,0,acept,1000,175,13,1188
Rio de Janeiro,120,3,2,1,acept,2480,235,32,2747
Rio de Janeiro,110,2,2,1,acept,3500,210,46,3756
Sao Paulo,30,1,1,1,acept,2800,72,36,2908
Sao Paulo,386,4,6,3,acept,12750,1980,162,14892
Rio de Janeiro,70,2,1,0,acept,2000,96,26,2122
Belo Horizonte,120,3,2,2,acept,1700,196,23,1919
Sao Paulo,300,2,3,2,acept,3560,1834,46,5440
Sao Paulo,40,1,1,0,not acept,780,17,12,809
Sao Paulo,210,3,2,1,acept,7500,450,96,8046
Rio de Janeiro,62,3,2,1,acept,2100,174,28,2302
Rio de Janeiro,84,3,2,1,acept,1820,234,24,2078
Sao Paulo,23,1,1,0,acept,2050,40,26,2116
Sao Paulo,140,2,4,2,not acept,6599,375,84,7058
Sao Paulo,40,1,1,1,acept,2100,13,27,2140
Sao Paulo,148,3,3,0,acept,2400,200,31,2631
Sao Paulo,75,3,2,2,acept,2300,87,30,2417
Sao Paulo,40,1,1,0,acept,650,17,10,677
Rio de Janeiro,77,2,2,2,acept,4200,301,55,4556
Sao Paulo,90,2,2,0,not acept,1800,0,23,1823
Rio de Janeiro,300,4,4,0,acept,3800,344,58,4202
Rio de Janeiro,98,2,2,0,not acept,3050,172,40,3262
Sao Paulo,64,2,2,1,acept,2800,0,36,2836
Sao Paulo,100,3,2,2,not acept,3500,217,45,3762
Belo Horizonte,80,2,1,0,acept,1500,104,20,1624
Sao Paulo,110,3,2,1,not acept,4400,259,56,4715
Sao Paulo,40,1,1,0,acept,1000,56,13,1069
Rio de Janeiro,80,2,1,0,acept,1800,74,24,1898
Sao Paulo,17,1,1,0,acept,2700,42,35,2777
Sao Paulo,137,2,2,1,not acept,4600,410,70,5080
Sao Paulo,230,4,3,4,not acept,6000,745,77,6822
Rio de Janeiro,90,3,3,1,acept,1700,52,22,1774
Sao Paulo,347,4,7,6,acept,8900,1000,134,10034
Belo Horizonte,200,4,3,0,acept,15000,36,246,15282
Sao Paulo,56,1,1,0,acept,1300,37,17,1354
Campinas,650,5,4,8,acept,8500,442,128,9070
Rio de Janeiro,30,1,1,0,acept,1200,45,16,1261
Campinas,52,1,1,1,acept,1250,123,16,1389
Sao Paulo,120,3,2,2,not acept,5000,0,36,5036
Rio de Janeiro,50,1,1,1,acept,1010,0,14,1024
Sao Paulo,120,3,2,1,acept,2000,230,26,2256
Belo Horizonte,80,2,2,2,acept,4800,300,64,5164
Sao Paulo,58,2,2,1,acept,4700,42,60,4802
Porto Alegre,89,3,1,0,acept,1100,85,17,1202
Sao Paulo,250,3,4,3,acept,9800,125,125,10050
Sao Paulo,242,5,3,2,acept,4250,380,64,4694
Sao Paulo,55,2,1,1,acept,2200,84,28,2312
Belo Horizonte,45,1,1,0,acept,1100,127,19,1246
Sao Paulo,204,4,6,4,acept,6800,940,87,7827
Rio de Janeiro,37,1,1,0,acept,1200,196,16,1412
Sao Paulo,50,1,1,0,acept,2640,0,34,2674
Sao Paulo,73,2,2,2,acept,1200,84,16,1300
Porto Alegre,180,6,2,2,acept,4100,234,60,4394
Rio de Janeiro,300,4,2,0,acept,6500,280,99,6879
Porto Alegre,71,2,2,1,acept,1300,79,19,1398
Sao Paulo,284,3,2,2,acept,6600,584,84,7268
Campinas,37,1,1,1,acept,555,0,8,563
Sao Paulo,35,1,1,0,not acept,750,34,12,796
Sao Paulo,190,2,2,4,acept,4200,0,64,4264
Sao Paulo,67,2,1,1,acept,1600,25,21,1646
Rio de Janeiro,98,2,2,0,acept,2882,223,38,3143
Sao Paulo,260,4,5,2,acept,8000,417,102,8519
Sao Paulo,139,3,2,2,not acept,3870,325,50,4245
Porto Alegre,76,2,2,1,acept,2200,0,33,2233
Belo Horizonte,150,3,2,1,acept,3000,224,40,3264
Rio de Janeiro,51,1,1,1,acept,1100,64,15,1179
Belo Horizonte,120,3,2,2,acept,1700,195,23,1918
Porto Alegre,42,1,1,0,acept,1050,0,16,1066
Belo Horizonte,180,4,2,2,acept,2800,267,38,3105
Sao Paulo,65,2,1,0,acept,4200,17,54,4271
Sao Paulo,420,5,4,4,acept,12000,200,153,12353
Sao Paulo,90,2,2,2,not acept,1400,850,18,2268
Sao Paulo,44,1,1,0,acept,1700,0,22,1722
Sao Paulo,240,2,3,1,acept,6500,30,83,6613
Sao Paulo,280,4,5,4,acept,6350,350,96,6796
Sao Paulo,120,2,2,3,acept,3300,575,42,3917
Belo Horizonte,140,4,3,4,not acept,2300,376,31,2707
Sao Paulo,65,2,2,1,acept,1750,68,23,1841
Belo Horizonte,52,1,2,1,acept,3600,211,48,3859
Porto Alegre,199,3,4,3,acept,8750,334,128,9212
Porto Alegre,71,2,2,1,acept,2700,100,40,2840
Sao Paulo,42,1,1,0,acept,2800,0,36,2836
Sao Paulo,420,4,3,4,acept,15000,1250,226,16476
Porto Alegre,169,2,1,1,acept,2800,55,50,2905
Sao Paulo,170,3,2,4,acept,1500,1130,20,2650
Sao Paulo,45,2,2,0,not acept,1650,84,25,1759
Sao Paulo,60,2,1,1,acept,2700,98,35,2833
Sao Paulo,76,3,2,2,acept,1450,104,19,1573
Porto Alegre,47,1,1,1,not acept,2200,0,33,2233
Sao Paulo,22,1,1,0,acept,2200,55,28,2283
Rio de Janeiro,63,2,2,1,acept,1800,92,24,1916
Sao Paulo,33,1,1,1,not acept,3600,0,46,3646
Sao Paulo,96,3,2,2,acept,2300,250,30,2580
Belo Horizonte,573,4,3,6,acept,10000,737,164,10901
Rio de Janeiro,84,3,1,0,acept,2400,209,31,2640
Campinas,400,4,4,3,acept,8700,458,131,9289
Belo Horizonte,150,3,3,2,acept,1950,0,26,1976
Sao Paulo,120,3,1,0,acept,2040,110,26,2176
Sao Paulo,78,2,1,1,acept,1700,82,26,1808
Sao Paulo,20,1,1,0,acept,1800,130,23,1953
Porto Alegre,117,2,1,1,acept,2100,73,31,2204
Sao Paulo,40,1,1,0,acept,2090,0,27,2117
Rio de Janeiro,50,2,1,0,not acept,1059,92,14,1165
Porto Alegre,80,3,1,1,acept,1300,46,19,1365
Sao Paulo,65,2,1,1,acept,2600,57,33,2690
Porto Alegre,90,2,2,0,acept,1125,34,17,1176
Sao Paulo,76,2,1,1,acept,5600,0,71,5671
Campinas,85,3,2,2,acept,3000,165,39,3204
Sao Paulo,76,1,2,2,acept,2800,220,36,3056
Rio de Janeiro,92,2,1,1,acept,1839,134,24,1997
Sao Paulo,150,3,3,3,acept,4600,234,70,4904
Sao Paulo,515,5,4,3,acept,15000,250,191,15441
Porto Alegre,91,2,1,0,acept,1350,69,20,1439
Sao Paulo,161,3,3,3,acept,15000,667,191,15858
Sao Paulo,64,2,1,1,acept,1400,11,18,1429
Porto Alegre,59,1,1,1,acept,2200,67,33,2300
Belo Horizonte,150,4,4,4,acept,4200,522,56,4778
Sao Paulo,90,3,4,2,acept,5500,266,70,5836
Rio de Janeiro,30,1,1,0,acept,1800,26,24,1850
Sao Paulo,127,2,3,1,acept,3200,15,49,3264
Sao Paulo,48,1,1,1,not acept,2300,133,30,2463
Sao Paulo,90,2,2,1,not acept,4500,414,68,4982
Sao Paulo,20,1,1,0,acept,1800,130,23,1953
Sao Paulo,82,2,1,1,acept,3300,21,42,3363
Sao Paulo,66,2,2,2,acept,2500,116,32,2648
Sao Paulo,81,3,1,1,acept,2800,142,36,2978
Sao Paulo,170,3,3,3,acept,4200,239,64,4503
Belo Horizonte,280,4,7,4,not acept,3000,660,40,3700
Belo Horizonte,70,2,1,1,acept,1400,90,19,1509
Porto Alegre,69,2,2,2,acept,2500,158,37,2695
Belo Horizonte,143,3,2,3,not acept,2500,170,34,2704
Sao Paulo,50,1,1,0,not acept,1250,34,19,1303
Campinas,102,3,2,0,acept,2500,248,32,2780
Sao Paulo,60,2,1,0,acept,1200,38,19,1257
Campinas,265,3,3,2,acept,2400,140,37,2577
Rio de Janeiro,76,2,1,1,acept,2750,179,36,2965
Sao Paulo,96,3,2,2,not acept,8500,285,108,8893
Sao Paulo,70,2,1,1,acept,1800,170,23,1993
Sao Paulo,140,3,4,2,acept,12000,615,153,12768
Sao Paulo,81,2,1,1,not acept,2810,217,36,3063
Porto Alegre,52,2,1,0,acept,1500,55,22,1577
Sao Paulo,298,5,3,3,acept,8000,1384,121,9505
Porto Alegre,70,2,2,2,acept,1600,59,24,1683
Sao Paulo,92,2,1,1,acept,1536,72,20,1628
Rio de Janeiro,190,4,3,2,acept,9300,375,120,9795
Porto Alegre,42,1,1,0,acept,700,40,11,751
Sao Paulo,40,1,1,1,not acept,2500,34,32,2566
Rio de Janeiro,312,4,4,3,acept,15000,1084,194,16278
Sao Paulo,106,2,1,2,not acept,2100,110,32,2242
Campinas,110,3,3,2,acept,3700,88,56,3844
Sao Paulo,384,5,5,3,acept,8000,1240,102,9342
Porto Alegre,69,2,1,0,acept,1200,410,18,1628
Sao Paulo,82,2,2,0,acept,4500,38,58,4596
Belo Horizonte,500,7,6,3,acept,15000,384,246,15630
Sao Paulo,130,3,2,1,acept,4500,334,58,4892
Sao Paulo,55,1,1,0,acept,1500,138,23,1661
Sao Paulo,170,4,4,2,not acept,2800,417,36,3253
Campinas,183,4,2,0,acept,2400,238,37,2675
Sao Paulo,336,3,5,3,acept,6000,208,91,6299
Sao Paulo,45,1,1,1,not acept,5520,0,70,5590
Sao Paulo,40,1,1,0,acept,1700,40,22,1762
Belo Horizonte,45,3,1,0,acept,1300,127,22,1449
Rio de Janeiro,180,3,3,0,acept,2550,170,39,2759
Sao Paulo,23,1,1,0,acept,2100,42,27,2169
Porto Alegre,53,1,1,0,acept,500,20,8,528
Sao Paulo,100,2,2,1,acept,4000,240,51,4291
Sao Paulo,400,4,5,4,acept,8700,1671,111,10482
Rio de Janeiro,92,1,3,1,not acept,2720,365,36,3121
Belo Horizonte,420,6,4,0,acept,3500,405,47,3952
Rio de Janeiro,78,3,1,1,not acept,2800,100,37,2937
Sao Paulo,70,2,1,1,not acept,1800,5,23,1828
Campinas,500,6,5,8,acept,8000,625,121,8746
Sao Paulo,130,3,4,2,not acept,2000,667,26,2693
Rio de Janeiro,24,1,1,0,not acept,2000,42,26,2068
Sao Paulo,125,2,1,1,acept,2000,63,26,2089
Sao Paulo,242,3,4,2,acept,4500,952,58,5510
Sao Paulo,69,3,1,1,acept,1199,0,16,1215
Sao Paulo,135,2,2,1,acept,3250,159,42,3451
Belo Horizonte,43,2,1,1,acept,620,100,9,729
Sao Paulo,565,4,5,6,acept,14850,2112,224,17186
Porto Alegre,62,2,1,1,not acept,1296,54,19,1369
Belo Horizonte,112,4,1,2,acept,1900,212,32,2144
Sao Paulo,31,1,1,1,acept,2500,75,32,2607
Sao Paulo,89,3,3,0,acept,3550,84,45,3679
Porto Alegre,100,2,2,0,acept,2200,0,40,2240
Sao Paulo,65,2,1,0,acept,6000,200,77,6277
Campinas,60,3,2,0,acept,2362,88,30,2480
Porto Alegre,75,3,2,1,not acept,1950,98,29,2077
Porto Alegre,41,1,1,1,acept,1150,35,17,1202
Sao Paulo,100,2,1,0,acept,3300,0,42,3342
Sao Paulo,288,3,2,2,acept,3700,457,56,4213
Sao Paulo,400,5,6,0,acept,5200,0,79,5279
Sao Paulo,240,3,2,1,acept,15000,667,226,15893
Sao Paulo,80,1,1,1,acept,1150,75,18,1243
Campinas,43,2,1,1,acept,1000,7,13,1020
Sao Paulo,25,1,1,0,not acept,1200,35,16,1251
Sao Paulo,49,2,1,1,not acept,2000,100,26,2126
Sao Paulo,40,1,1,0,not acept,970,63,15,1048
Porto Alegre,71,2,1,0,acept,1500,0,22,1522
Sao Paulo,50,2,1,0,acept,1430,25,19,1474
Sao Paulo,44,1,1,0,acept,1800,125,28,1953
Sao Paulo,400,4,2,8,acept,7200,117,109,7426
Porto Alegre,225,3,3,2,acept,3800,192,56,4048
Rio de Janeiro,82,3,2,2,acept,2200,92,29,2321
Sao Paulo,102,3,1,1,acept,1760,0,27,1787
Porto Alegre,981,3,2,4,acept,7000,4500,125,11625
Rio de Janeiro,25,1,1,0,acept,700,0,10,710
Sao Paulo,230,3,4,0,acept,3000,700,39,3739
Sao Paulo,280,3,4,3,acept,5200,250,66,5516
Sao Paulo,69,3,1,1,acept,1350,84,18,1452
Rio de Janeiro,58,1,2,0,acept,1600,90,21,1711
Campinas,58,1,1,0,acept,1050,38,14,1102
Campinas,64,2,1,1,acept,730,18,10,758
Sao Paulo,84,3,1,1,acept,2180,100,28,2308
Rio de Janeiro,35,1,1,0,not acept,1100,21,15,1136
Rio de Janeiro,78,2,1,0,acept,1600,94,21,1715
Sao Paulo,55,2,1,2,not acept,980,142,13,1135
Sao Paulo,250,4,5,4,acept,15000,1540,191,16731
Rio de Janeiro,110,3,2,0,not acept,4860,300,63,5223
Sao Paulo,206,2,1,3,acept,3500,214,53,3767
Sao Paulo,150,3,4,1,acept,4250,491,64,4805
Sao Paulo,180,4,3,2,acept,9000,460,115,9575
Sao Paulo,330,4,5,4,acept,6500,750,98,7348
Sao Paulo,68,1,1,0,not acept,1100,0,17,1117
Sao Paulo,280,4,4,4,not acept,6000,100,77,6177
Campinas,85,3,2,1,acept,1500,63,20,1583
Sao Paulo,55,2,1,0,acept,1530,0,20,1550
Sao Paulo,90,3,2,1,not acept,2800,25,36,2861
Belo Horizonte,96,3,1,1,not acept,1200,34,20,1254
Belo Horizonte,250,4,1,8,acept,2125,231,35,2391
Porto Alegre,80,2,2,1,acept,1800,100,27,1927
Porto Alegre,41,1,2,1,acept,2800,67,41,2908
Sao Paulo,75,2,1,3,not acept,2500,250,32,2782
Sao Paulo,800,7,7,8,acept,9000,3000,136,12136
Rio de Janeiro,45,1,1,0,acept,1000,34,13,1047
Sao Paulo,74,2,2,2,acept,5000,120,64,5184
Belo Horizonte,160,4,3,2,acept,3700,143,61,3904
Sao Paulo,50,1,1,0,acept,1500,59,20,1579
Sao Paulo,126,2,3,1,acept,10000,317,127,10444
Rio de Janeiro,65,1,1,1,not acept,4000,434,52,4486
Sao Paulo,120,3,2,2,acept,4000,238,51,4289
Belo Horizonte,150,4,2,2,acept,4200,396,56,4652
Campinas,76,1,1,1,not acept,2500,130,32,2662
Sao Paulo,226,4,5,4,acept,15000,2242,191,17433
Sao Paulo,22,1,1,0,not acept,976,0,15,991
Campinas,154,3,3,1,not acept,6500,0,83,6583
Sao Paulo,56,2,2,2,acept,1630,42,21,1693
Belo Horizonte,212,3,5,4,acept,4200,393,69,4662
Sao Paulo,62,3,2,1,acept,1300,75,17,1392
Rio de Janeiro,80,2,2,2,not acept,7800,327,101,8228
Sao Paulo,420,4,4,4,acept,12000,2000,153,14153
Porto Alegre,32,1,1,0,acept,750,23,11,784
Sao Paulo,30,1,1,1,not acept,3000,0,39,3039
Campinas,70,2,2,0,not acept,1000,62,16,1078
Sao Paulo,200,3,3,2,not acept,6000,750,91,6841
Sao Paulo,25,1,1,0,acept,1330,0,17,1347
Sao Paulo,42,1,1,1,acept,3696,17,47,3760
Sao Paulo,135,3,3,2,acept,4250,584,54,4888
Porto Alegre,47,1,1,0,acept,900,38,14,952
Porto Alegre,35,1,1,0,acept,880,15,13,908
Sao Paulo,75,3,2,0,not acept,2236,64,29,2329
Sao Paulo,300,2,2,0,acept,3000,292,46,3338
Sao Paulo,45,1,1,1,not acept,2300,167,30,2497
Belo Horizonte,850,5,7,8,acept,10000,1,164,10165
Porto Alegre,140,3,2,2,acept,3000,250,44,3294
Sao Paulo,60,2,1,0,not acept,1222,0,19,1241
Sao Paulo,50,1,1,0,not acept,1250,34,19,1303
Campinas,150,4,5,2,acept,2860,360,37,3257
Sao Paulo,160,3,2,1,acept,7693,223,116,8032
Sao Paulo,334,3,3,8,acept,8600,209,130,8939
Sao Paulo,330,4,3,0,acept,9800,750,148,10698
Porto Alegre,38,1,1,0,acept,1800,20,27,1847
Belo Horizonte,280,4,7,4,not acept,3000,642,40,3682
Sao Paulo,200,3,3,2,acept,6500,417,83,7000
Sao Paulo,100,4,5,2,acept,8500,500,108,9108
Rio de Janeiro,80,2,1,0,acept,1400,101,19,1520
Sao Paulo,267,3,6,6,acept,4800,470,73,5343
Rio de Janeiro,130,3,1,1,acept,3500,184,46,3730
Belo Horizonte,70,2,3,1,acept,2450,165,33,2648
Sao Paulo,213,3,5,5,acept,6200,0,79,6279
Sao Paulo,35,1,1,0,not acept,780,40,12,832
Belo Horizonte,312,4,5,4,acept,15000,1747,200,16947
Sao Paulo,160,3,4,3,acept,2500,298,32,2830
Sao Paulo,22,1,1,0,acept,2000,44,26,2070
Sao Paulo,400,4,4,3,acept,10000,0,127,10127
Sao Paulo,45,1,2,1,acept,2100,99,27,2226
Sao Paulo,237,4,4,0,not acept,8000,1031,102,9133
Sao Paulo,180,3,3,0,acept,13000,715,196,13911
Sao Paulo,30,1,1,0,not acept,1805,0,23,1828
Sao Paulo,13,1,1,0,acept,2200,42,28,2270
Sao Paulo,140,4,4,2,acept,6800,107,103,7010
Belo Horizonte,62,2,1,1,acept,1050,84,14,1148
Rio de Janeiro,76,2,1,0,acept,1000,50,13,1063
Sao Paulo,220,3,4,4,acept,4250,711,54,5015
Campinas,143,3,3,2,acept,3300,250,42,3592
Campinas,44,2,1,0,acept,650,0,9,659
Sao Paulo,90,3,2,1,acept,1450,65,19,1534
Belo Horizonte,190,4,3,3,acept,4800,357,64,5221
Sao Paulo,79,2,3,1,acept,3100,500,40,3640
Sao Paulo,45,1,1,2,acept,1800,170,23,1993
Campinas,73,3,2,2,acept,2400,125,31,2556
Sao Paulo,168,3,4,5,acept,3600,190,46,3836
Sao Paulo,95,3,2,3,not acept,2500,41,32,2573
Porto Alegre,180,2,2,1,acept,2001,25,30,2056
Porto Alegre,65,2,2,0,not acept,1390,87,21,1498
Belo Horizonte,110,4,2,0,acept,1850,0,31,1881
Sao Paulo,58,1,1,1,acept,4700,200,60,4960
Belo Horizonte,15,1,1,0,acept,665,0,9,674
Sao Paulo,213,4,3,5,acept,3900,298,59,4257
Sao Paulo,162,4,4,3,not acept,5500,891,70,6461
Sao Paulo,49,1,1,0,not acept,3800,89,49,3938
Sao Paulo,32,1,1,0,acept,1400,0,18,1418
Belo Horizonte,78,3,2,2,acept,2300,229,31,2560
Porto Alegre,240,4,4,2,acept,5000,630,89,5719
Campinas,150,3,2,1,acept,1320,167,20,1507
Belo Horizonte,60,2,1,1,acept,1200,97,16,1313
Belo Horizonte,160,3,2,3,not acept,3500,177,47,3724
Sao Paulo,74,2,2,2,acept,3400,163,44,3607
Sao Paulo,280,4,4,8,acept,7040,688,106,7834
Porto Alegre,42,1,1,0,not acept,850,21,13,884
Porto Alegre,102,3,2,5,acept,2975,103,53,3131
Sao Paulo,123,3,2,2,acept,2174,283,28,2485
Porto Alegre,50,2,1,1,acept,1000,25,18,1043
Sao Paulo,125,3,2,2,acept,1700,5,26,1731
Porto Alegre,240,3,2,4,acept,5500,500,98,6098
Sao Paulo,85,3,2,3,acept,1999,153,26,2178
Belo Horizonte,260,4,5,4,acept,15000,153,200,15353
Sao Paulo,22,1,1,0,not acept,870,0,14,884
Sao Paulo,278,3,2,1,acept,7800,601,99,8500
Sao Paulo,18,1,1,0,acept,1130,30,15,1175
Rio de Janeiro,196,3,4,1,acept,5500,500,71,6071
Sao Paulo,26,1,1,0,acept,3500,1,45,3546
Sao Paulo,100,4,2,2,acept,3500,42,53,3595
Sao Paulo,460,4,3,6,acept,10000,1667,127,11794
Sao Paulo,189,4,3,2,not acept,6500,584,83,7167
Sao Paulo,226,3,3,0,acept,6000,34,91,6125
Sao Paulo,418,2,4,3,not acept,6875,117,88,7080
Campinas,660,5,5,4,acept,5000,1000,76,6076
Campinas,120,1,2,1,acept,1112,0,17,1129
Sao Paulo,70,2,1,1,acept,1100,20,14,1134
Sao Paulo,400,10,5,8,acept,10900,1417,164,12481
Campinas,82,3,3,2,acept,1500,153,20,1673
Sao Paulo,210,3,4,4,acept,15000,1000,191,16191
Sao Paulo,92,3,2,2,acept,1900,105,25,2030
Belo Horizonte,64,3,1,0,not acept,1400,27,19,1446
Porto Alegre,35,2,1,0,not acept,1350,0,20,1370
Sao Paulo,120,2,2,2,acept,2690,226,41,2957
Sao Paulo,16,1,1,0,not acept,1200,59,16,1275
Porto Alegre,60,2,1,0,acept,950,0,14,964
Campinas,223,3,5,2,acept,3300,290,42,3632
Sao Paulo,50,1,1,0,not acept,800,0,13,813
Porto Alegre,30,1,1,0,acept,940,35,14,989
Sao Paulo,111,2,2,1,not acept,3500,175,45,3720
Sao Paulo,290,4,3,2,not acept,7150,862,91,8103
Campinas,80,3,1,1,acept,1328,50,10,1388
Sao Paulo,353,4,5,5,acept,10000,0,127,10127
Sao Paulo,55,2,1,1,acept,1990,80,26,2096
Campinas,49,2,1,1,acept,1000,38,13,1051
Rio de Janeiro,50,2,1,0,acept,850,21,11,882
Sao Paulo,182,4,4,2,acept,6000,605,77,6682
Sao Paulo,42,1,1,1,acept,3800,24,49,3873
Sao Paulo,500,5,7,5,acept,14000,2084,178,16262
Sao Paulo,56,1,1,0,not acept,1200,48,19,1267
Rio de Janeiro,170,3,2,1,acept,4600,384,60,5044
Sao Paulo,160,3,3,2,acept,5000,570,64,5634
Sao Paulo,70,1,1,2,acept,1300,63,20,1383
Campinas,120,2,1,4,acept,2400,59,37,2496
Rio de Janeiro,65,2,1,1,acept,1650,0,22,1672
Sao Paulo,300,4,4,6,not acept,5500,1180,70,6750
Sao Paulo,140,3,2,2,acept,12000,209,153,12362
Sao Paulo,108,2,3,2,acept,2100,250,32,2382
Porto Alegre,220,3,3,4,acept,2500,2360,45,4905
Sao Paulo,157,3,3,4,acept,4900,725,63,5688
Sao Paulo,101,3,4,2,acept,3120,340,40,3500
Sao Paulo,87,3,2,4,acept,2000,67,26,2093
Campinas,123,3,2,2,acept,2000,148,26,2174
Sao Paulo,67,1,2,1,acept,2479,117,32,2628
Sao Paulo,200,3,3,8,acept,4480,509,68,5057
Sao Paulo,48,2,1,1,acept,1720,0,22,1742
Belo Horizonte,51,2,1,1,acept,700,27,10,737
Sao Paulo,54,2,1,1,not acept,1300,4,17,1321
Sao Paulo,280,3,3,2,acept,5650,692,72,6414
Sao Paulo,172,3,4,3,acept,7800,890,99,8789
Sao Paulo,136,3,2,2,acept,15000,374,191,15565
Sao Paulo,300,4,2,0,acept,15000,834,191,16025
Sao Paulo,26,1,1,0,acept,2300,42,30,2372
Rio de Janeiro,52,1,1,0,acept,1172,50,16,1238
Rio de Janeiro,72,2,2,1,acept,1200,5,16,1221
Rio de Janeiro,240,3,3,1,acept,7000,417,91,7508
Sao Paulo,100,3,2,6,acept,7500,1000,113,8613
Rio de Janeiro,145,3,3,2,not acept,11960,0,155,12115
Sao Paulo,60,2,2,2,acept,1950,67,30,2047
Porto Alegre,260,2,2,1,acept,2000,25,30,2055
Belo Horizonte,28,1,1,0,not acept,1100,0,15,1115
Campinas,25,1,1,0,not acept,1000,0,13,1013
Sao Paulo,45,2,1,1,acept,1920,34,25,1979
Belo Horizonte,115,3,2,2,acept,1950,133,26,2109
Porto Alegre,48,2,1,0,acept,800,28,12,840
Sao Paulo,150,3,3,8,acept,8000,1084,121,9205
Sao Paulo,160,4,3,2,acept,3800,250,58,4108
Sao Paulo,700,4,4,4,acept,10000,21880,151,32031
Sao Paulo,340,4,6,4,not acept,7650,1667,97,9414
Rio de Janeiro,25,1,1,0,acept,1513,0,7,1520
Sao Paulo,79,3,2,2,acept,1290,90,17,1397
Sao Paulo,35,1,1,1,acept,1600,134,21,1755
Sao Paulo,270,3,4,0,acept,3500,165,45,3710
Sao Paulo,156,3,4,3,not acept,5000,500,64,5564
Sao Paulo,50,1,1,1,acept,2800,0,20,2820
Sao Paulo,60,1,1,2,not acept,1900,288,25,2213
Sao Paulo,140,3,4,3,acept,4000,489,51,4540
Sao Paulo,53,1,1,0,not acept,1680,68,22,1770
Sao Paulo,200,4,4,4,acept,4220,450,64,4734
Belo Horizonte,125,4,2,2,not acept,2100,267,28,2395
Sao Paulo,160,3,4,3,acept,9350,0,141,9491
Campinas,300,4,5,3,acept,9500,459,121,10080
Belo Horizonte,175,3,3,2,acept,3700,205,50,3955
Rio de Janeiro,158,3,2,2,acept,8000,445,104,8549
Rio de Janeiro,110,3,2,1,acept,2850,259,37,3146
Sao Paulo,168,3,2,2,acept,2500,152,38,2690
Sao Paulo,120,3,1,2,not acept,3500,117,53,3670
Belo Horizonte,230,4,3,4,acept,15000,1500,200,16700
Sao Paulo,255,3,4,2,acept,6000,500,77,6577
Sao Paulo,23,1,1,1,acept,2300,59,30,2389
Sao Paulo,120,3,2,1,not acept,2500,160,32,2692
Sao Paulo,45,1,1,2,acept,1800,170,23,1993
Belo Horizonte,154,3,2,1,acept,2000,159,27,2186
Rio de Janeiro,50,1,1,1,not acept,4520,0,59,4579
Rio de Janeiro,104,3,2,2,acept,7000,337,91,7428
Sao Paulo,50,2,1,1,acept,2430,124,31,2585
Porto Alegre,75,2,2,1,acept,1400,117,21,1538
Sao Paulo,145,3,2,1,acept,2000,12,26,2038
Sao Paulo,211,3,5,3,acept,7000,750,89,7839
Sao Paulo,30,1,1,0,not acept,2060,0,27,2087
Campinas,170,4,3,1,not acept,3700,0,47,3747
Sao Paulo,86,2,2,1,acept,1900,93,25,2018
Rio de Janeiro,230,3,4,3,acept,3000,556,39,3595
Sao Paulo,61,1,2,2,not acept,4000,250,51,4301
Sao Paulo,383,4,4,5,not acept,3004,709,39,3752
Sao Paulo,210,3,3,0,acept,5500,734,83,6317
Sao Paulo,60,2,2,1,not acept,5650,59,72,5781
Sao Paulo,213,4,6,4,acept,8500,970,108,9578
Porto Alegre,93,2,2,3,acept,3900,224,57,4181
Sao Paulo,50,1,1,1,not acept,5300,212,68,5580
Sao Paulo,149,2,3,3,acept,4500,883,58,5441
Sao Paulo,410,4,5,5,acept,20000,0,254,20254
Sao Paulo,40,1,1,1,acept,3175,105,41,3321
Rio de Janeiro,46,1,1,0,acept,1500,101,20,1621
Sao Paulo,378,4,4,8,acept,10000,1334,151,11485
Sao Paulo,60,2,2,2,acept,3800,132,49,3981
Rio de Janeiro,180,2,3,1,acept,8500,700,110,9310
Belo Horizonte,70,2,2,2,not acept,1450,94,20,1564
Sao Paulo,68,2,1,1,acept,2100,0,27,2127
Rio de Janeiro,85,2,2,1,acept,1800,78,24,1902
Belo Horizonte,140,4,2,2,acept,2281,221,31,2533
Belo Horizonte,52,2,2,1,not acept,1650,86,22,1758
Porto Alegre,63,2,2,0,not acept,2600,109,38,2747
Sao Paulo,65,2,2,2,acept,3300,207,42,3549
Belo Horizonte,60,3,1,1,acept,950,63,13,1026
Belo Horizonte,27,1,1,0,not acept,1167,334,16,1517
Sao Paulo,260,4,4,3,not acept,15000,1417,191,16608
Sao Paulo,44,1,1,1,acept,1200,0,16,1216
Sao Paulo,170,3,3,2,acept,4850,334,73,5257
Sao Paulo,118,3,2,1,not acept,4775,185,61,5021
Sao Paulo,114,3,2,2,acept,3780,100,48,3928
Belo Horizonte,154,4,2,2,acept,2800,305,38,3143
Rio de Janeiro,108,3,1,1,not acept,15000,334,194,15528
Sao Paulo,147,3,2,2,acept,3600,414,46,4060
Sao Paulo,365,3,4,3,acept,12000,1250,153,13403
Porto Alegre,109,3,2,1,acept,2423,193,36,2652
Belo Horizonte,148,3,3,2,acept,2500,104,34,2638
Sao Paulo,250,3,4,2,acept,6000,75,91,6166
Campinas,79,2,1,1,not acept,1000,25,13,1038
Rio de Janeiro,66,2,1,1,acept,2400,179,31,2610
Campinas,54,1,1,1,not acept,1370,31,18,1419
Campinas,87,3,1,1,acept,1200,64,16,1280
Sao Paulo,640,4,4,4,acept,10200,1584,130,11914
Sao Paulo,71,2,1,0,acept,1040,0,14,1054
Sao Paulo,35,1,1,1,not acept,1250,90,16,1356
Sao Paulo,57,2,2,1,not acept,2300,50,30,2380
Sao Paulo,38,1,1,0,not acept,1220,25,16,1261
Rio de Janeiro,70,2,2,1,acept,3700,122,48,3870
Sao Paulo,350,2,4,8,not acept,3300,450,50,3800
Rio de Janeiro,300,4,3,2,not acept,12000,750,155,12905
Porto Alegre,80,2,2,0,acept,1320,121,20,1461
Rio de Janeiro,160,3,3,1,acept,2900,317,38,3255
Porto Alegre,117,3,2,2,acept,5500,167,81,5748
Porto Alegre,112,3,2,2,acept,4100,100,60,4260
Rio de Janeiro,100,2,2,1,acept,1870,0,29,1899
Rio de Janeiro,160,4,2,1,acept,4230,0,55,4285
Porto Alegre,68,2,1,0,acept,700,19,11,730
Sao Paulo,530,4,4,4,not acept,5000,1636,64,6700
Sao Paulo,210,3,2,2,acept,3500,101,53,3654
Rio de Janeiro,33,1,1,0,not acept,3300,100,25,3425
Sao Paulo,40,2,1,0,acept,1100,0,14,1114
Belo Horizonte,200,5,5,8,acept,6000,1017,99,7116
Sao Paulo,58,2,1,2,acept,1360,0,18,1378
Sao Paulo,120,3,3,2,acept,3400,134,44,3578
Sao Paulo,162,3,4,0,acept,3200,267,49,3516
Sao Paulo,301,4,5,4,acept,12500,1600,159,14259
Sao Paulo,40,1,1,0,not acept,1800,38,23,1861
Rio de Janeiro,45,1,1,0,acept,1000,34,13,1047
Rio de Janeiro,135,3,2,1,acept,3060,428,40,3528
Sao Paulo,135,3,2,1,acept,3290,279,42,3611
Porto Alegre,102,3,2,2,acept,5525,225,81,5831
Sao Paulo,76,2,2,2,acept,1400,123,18,1541
Sao Paulo,180,4,1,1,acept,8500,400,108,9008
Belo Horizonte,72,2,2,1,acept,1250,66,21,1337
Sao Paulo,128,2,3,1,acept,4339,85,55,4479
Campinas,60,3,2,0,acept,2362,88,30,2480
Sao Paulo,44,1,1,0,acept,2500,30,32,2562
Sao Paulo,189,3,3,1,acept,5800,371,74,6245
Porto Alegre,450,6,2,8,acept,4000,197,72,4269
Sao Paulo,286,4,4,5,acept,10800,1125,163,12088
Sao Paulo,276,4,6,4,acept,4500,1713,58,6271
Sao Paulo,60,1,2,1,not acept,3800,0,49,3849
Sao Paulo,40,1,1,0,not acept,880,48,14,942
Rio de Janeiro,57,2,2,1,acept,1800,0,24,1824
Campinas,45,1,1,1,acept,600,38,8,646
Sao Paulo,42,1,1,1,not acept,3500,22,45,3567
Rio de Janeiro,68,2,1,1,acept,1100,42,15,1157
Rio de Janeiro,120,3,2,1,acept,4800,355,62,5217
Sao Paulo,360,4,4,2,acept,11050,0,141,11191
Sao Paulo,140,2,1,0,acept,1650,167,25,1842
Sao Paulo,35,1,1,0,acept,1100,30,14,1144
Sao Paulo,16,1,1,0,not acept,910,0,12,922
Campinas,110,3,1,1,acept,1100,108,9,1217
Campinas,69,2,1,1,not acept,980,60,13,1053
Belo Horizonte,59,2,2,0,not acept,1400,112,19,1531
Sao Paulo,336,4,4,6,acept,7677,950,116,8743
Sao Paulo,210,4,4,3,acept,5000,917,64,5981
Sao Paulo,242,4,5,4,acept,12000,930,153,13083
Porto Alegre,28,1,1,0,acept,550,21,9,580
Sao Paulo,220,4,3,3,not acept,9000,1203,115,10318
Porto Alegre,62,3,2,1,not acept,1629,54,24,1707
Rio de Janeiro,111,3,2,2,acept,3500,325,46,3871
Campinas,159,3,2,2,acept,2500,334,32,2866
Rio de Janeiro,70,2,2,0,acept,2250,100,29,2379
Sao Paulo,150,3,2,2,acept,2000,384,26,2410
Sao Paulo,50,1,1,1,acept,4000,126,51,4177
Sao Paulo,450,3,3,8,acept,5015,400,76,5491
Belo Horizonte,64,2,1,1,acept,850,78,12,940
Sao Paulo,600,5,7,5,acept,5200,155,79,5434
Sao Paulo,70,1,1,0,acept,3200,109,41,3350
Sao Paulo,76,3,2,0,acept,1240,95,16,1351
Sao Paulo,280,3,3,4,acept,6520,834,99,7453
Sao Paulo,172,2,4,3,acept,11000,775,140,11915
Sao Paulo,246,3,4,4,acept,12000,750,153,12903
Sao Paulo,64,2,1,1,acept,1500,101,20,1621
Belo Horizonte,30,1,1,0,not acept,550,0,8,558
Sao Paulo,80,3,2,1,acept,2170,47,33,2250
Rio de Janeiro,87,3,1,1,acept,1800,159,24,1983
Porto Alegre,50,1,1,1,acept,800,0,12,812
Porto Alegre,50,1,1,0,acept,800,20,12,832
Sao Paulo,30,1,1,0,not acept,1850,167,28,2045
Sao Paulo,43,1,1,0,acept,1472,42,6,1520
Sao Paulo,300,3,4,0,acept,10000,2000,151,12151
Campinas,58,1,2,1,not acept,750,40,10,800
Sao Paulo,30,1,1,1,not acept,1660,18,22,1700
Sao Paulo,54,2,1,0,not acept,1700,135,22,1857
Rio de Janeiro,80,2,2,1,not acept,3500,167,46,3713
Porto Alegre,62,2,2,1,acept,1600,9,24,1633
Porto Alegre,66,2,2,0,acept,1200,50,18,1268
Sao Paulo,80,2,2,1,acept,1500,36,20,1556
Sao Paulo,560,4,4,7,acept,15000,5000,191,20191
Sao Paulo,30,1,1,1,acept,3900,84,50,4034
Sao Paulo,50,1,1,0,acept,1600,0,25,1625
Rio de Janeiro,81,2,2,1,acept,3500,225,46,3771
Sao Paulo,218,4,4,4,not acept,4930,1454,63,6447
Campinas,54,2,1,2,acept,1200,46,16,1262
Rio de Janeiro,60,2,1,0,not acept,1200,0,19,1219
Belo Horizonte,100,3,1,1,acept,1200,0,16,1216
Sao Paulo,156,2,3,2,acept,13590,292,173,14055
Sao Paulo,300,3,4,3,acept,4000,0,51,4051
Sao Paulo,39,1,1,1,not acept,2500,115,32,2647
Sao Paulo,150,4,3,4,acept,3000,500,46,3546
Sao Paulo,140,2,3,4,acept,6170,417,79,6666
Sao Paulo,240,4,4,3,acept,4200,792,54,5046
Sao Paulo,70,2,1,0,acept,1300,70,20,1390
Campinas,462,4,7,4,acept,5000,590,76,5666
Campinas,67,3,1,1,not acept,890,40,12,942
Belo Horizonte,100,2,1,0,acept,1200,63,20,1283
Belo Horizonte,113,3,3,1,acept,1100,88,15,1203
Sao Paulo,99,3,2,1,acept,2500,90,32,2622
Sao Paulo,120,2,1,1,acept,2100,175,32,2307
Sao Paulo,110,3,2,3,acept,2600,400,40,3040
Porto Alegre,38,1,1,1,acept,980,51,15,1046
Campinas,100,3,1,1,acept,1090,94,14,1198
Rio de Janeiro,135,4,2,2,acept,4200,468,55,4723
Rio de Janeiro,130,3,2,1,acept,3250,450,42,3742
Belo Horizonte,80,3,2,1,acept,1200,122,16,1338
Sao Paulo,300,3,2,5,acept,11500,2000,173,13673
Belo Horizonte,72,2,1,2,not acept,1300,97,18,1415
Sao Paulo,70,3,2,2,acept,1659,44,22,1725
Sao Paulo,395,4,4,3,acept,15000,834,191,16025
Porto Alegre,540,6,8,3,acept,15000,467,267,15734
Sao Paulo,318,4,6,4,acept,10160,0,129,10289
Belo Horizonte,42,2,1,1,acept,900,27,12,939
Rio de Janeiro,52,1,1,1,acept,1400,22,19,1441
Sao Paulo,167,3,2,1,acept,10850,532,138,11520
Sao Paulo,50,1,1,0,not acept,1209,129,8,1346
Campinas,65,2,2,1,not acept,1000,45,13,1058
Sao Paulo,140,4,4,3,acept,3600,583,46,4229
Sao Paulo,92,3,1,1,acept,1600,4,21,1625
Belo Horizonte,150,4,3,3,not acept,3300,293,44,3637
Campinas,60,1,1,0,acept,1300,75,17,1392
Belo Horizonte,308,4,5,6,acept,13500,173,180,13853
Sao Paulo,159,2,3,1,not acept,3230,49,41,3320
Sao Paulo,240,3,5,4,acept,7500,459,113,8072
Porto Alegre,65,3,2,0,not acept,1690,86,25,1801
Sao Paulo,200,3,2,2,acept,5000,167,76,5243
Campinas,130,3,5,2,acept,3610,209,46,3865
Rio de Janeiro,21,1,1,0,acept,1200,0,16,1216
Sao Paulo,68,2,1,1,acept,1600,142,21,1763
Porto Alegre,40,1,1,0,acept,900,38,14,952
Belo Horizonte,310,4,3,6,acept,3100,187,51,3338
Campinas,103,2,1,1,not acept,1060,84,14,1158
Rio de Janeiro,650,5,7,4,acept,15000,4241,229,19470
Campinas,30,1,1,0,not acept,500,10,7,517
Belo Horizonte,155,4,5,3,not acept,5000,593,67,5660
Sao Paulo,107,2,2,1,acept,2600,0,33,2633
Sao Paulo,340,4,5,5,acept,12000,3400,153,15553
Belo Horizonte,70,3,1,0,not acept,1200,104,16,1320
Belo Horizonte,58,2,2,1,acept,950,86,13,1049
Sao Paulo,70,3,2,1,not acept,3300,159,42,3501
Sao Paulo,240,3,3,0,acept,4300,292,65,4657
Rio de Janeiro,130,3,2,1,acept,2800,300,37,3137
Sao Paulo,310,5,6,5,acept,10000,1834,127,11961
Rio de Janeiro,60,1,1,1,acept,1300,54,17,1371
Sao Paulo,319,4,6,5,not acept,10050,2900,128,13078
Porto Alegre,81,2,1,0,acept,1150,5,17,1172
Belo Horizonte,306,3,5,0,acept,8000,0,132,8132
Sao Paulo,113,2,2,1,acept,3000,50,39,3089
Sao Paulo,280,3,4,2,not acept,6000,1059,77,7136
Sao Paulo,270,3,3,3,acept,13000,959,165,14124
Sao Paulo,78,2,1,1,acept,2000,35,26,2061
Sao Paulo,60,1,2,1,acept,1500,30,23,1553
Sao Paulo,30,1,1,0,acept,750,59,12,821
Rio de Janeiro,58,2,1,1,acept,800,77,11,888
Rio de Janeiro,65,1,1,0,acept,1800,30,24,1854
Sao Paulo,58,1,1,1,not acept,1740,75,23,1838
Sao Paulo,22,1,1,0,acept,2100,40,27,2167
Sao Paulo,32,1,1,1,not acept,3200,174,41,3415
Campinas,176,3,5,3,acept,5200,442,66,5708
Belo Horizonte,350,7,5,4,acept,7500,357,123,7980
Sao Paulo,260,4,4,2,acept,4400,584,56,5040
Sao Paulo,100,2,1,0,acept,2300,198,35,2533
Rio de Janeiro,65,1,1,0,not acept,3500,142,46,3688
Rio de Janeiro,600,7,6,1,not acept,15000,1167,194,16361
Rio de Janeiro,300,4,3,1,acept,5000,367,77,5444
Sao Paulo,430,4,3,4,acept,8500,1427,128,10055
Sao Paulo,260,5,5,4,not acept,8000,2620,102,10722
Belo Horizonte,211,3,4,3,not acept,8400,292,138,8830
Campinas,103,3,2,1,not acept,1800,113,23,1936
Porto Alegre,62,2,2,0,acept,1556,100,23,1679
Rio de Janeiro,80,2,2,1,acept,3499,205,46,3750
Sao Paulo,60,1,1,1,not acept,1180,0,18,1198
Sao Paulo,27,1,1,0,not acept,3500,1,45,3546
Sao Paulo,486,4,6,5,not acept,4861,3772,62,8695
Sao Paulo,40,1,1,1,acept,1680,102,22,1804
Rio de Janeiro,60,2,1,0,acept,2800,97,37,2934
Rio de Janeiro,64,2,2,0,acept,2200,104,29,2333
Campinas,660,5,7,4,acept,10000,1100,127,11227
Sao Paulo,62,3,2,1,acept,2400,54,31,2485
Porto Alegre,50,2,1,1,acept,946,0,14,960
Sao Paulo,380,3,4,4,acept,8000,952,121,9073
Campinas,134,3,3,2,not acept,2500,177,32,2709
Sao Paulo,74,2,2,0,acept,3600,210,46,3856
Belo Horizonte,68,2,2,1,acept,2500,207,34,2741
Rio de Janeiro,33,1,1,0,acept,1600,72,21,1693
Sao Paulo,60,2,1,0,acept,1100,0,17,1117
Sao Paulo,50,1,1,1,not acept,3700,30,47,3777
Sao Paulo,57,2,2,2,acept,1630,189,21,1840
Sao Paulo,39,1,1,1,acept,995,49,13,1057
Porto Alegre,45,1,1,1,not acept,760,0,12,772
Sao Paulo,221,3,2,2,acept,4500,200,58,4758
Sao Paulo,140,3,2,0,acept,1799,375,23,2197
Rio de Janeiro,650,5,4,2,acept,9000,1431,116,10547
Sao Paulo,210,5,4,1,acept,15000,1667,226,16893
Belo Horizonte,100,4,2,3,acept,2600,238,35,2873
Rio de Janeiro,220,3,3,2,acept,9000,367,116,9483
Sao Paulo,42,1,1,0,acept,1150,27,15,1192
Rio de Janeiro,98,3,2,0,acept,3000,185,39,3224
Rio de Janeiro,150,3,1,2,acept,5200,710,68,5978
Sao Paulo,170,3,3,4,acept,3500,222,53,3775
Sao Paulo,60,2,1,0,acept,1610,0,25,1635
Sao Paulo,120,3,4,2,acept,3450,149,52,3651
Sao Paulo,142,2,3,2,acept,3550,492,45,4087
Porto Alegre,90,2,2,1,not acept,2500,84,37,2621
Sao Paulo,140,3,3,2,acept,6000,500,77,6577
Rio de Janeiro,26,1,1,0,acept,1200,26,16,1242
Sao Paulo,20,1,1,0,not acept,790,0,11,801
Porto Alegre,24,1,1,1,not acept,550,0,9,559
Rio de Janeiro,140,3,2,0,acept,2900,194,38,3132
Belo Horizonte,134,4,2,3,not acept,3000,313,40,3353
Sao Paulo,400,5,4,2,acept,2000,832,26,2858
Rio de Janeiro,18,1,1,0,acept,650,49,9,708
Rio de Janeiro,62,1,1,1,acept,2800,182,37,3019
Sao Paulo,192,3,3,3,acept,6500,630,83,7213
Sao Paulo,80,3,2,1,acept,1790,128,23,1941
Porto Alegre,38,1,1,1,acept,2900,42,43,2985
Belo Horizonte,112,2,3,2,acept,1400,92,19,1511
Rio de Janeiro,15,1,1,0,not acept,1100,0,15,1115
Sao Paulo,29,1,1,0,acept,1043,0,14,1057
Belo Horizonte,55,2,1,1,acept,1050,0,14,1064
Sao Paulo,88,3,1,2,acept,2500,84,32,2616
Sao Paulo,100,4,1,0,acept,1600,100,25,1725
Belo Horizonte,92,3,2,1,acept,1800,141,24,1965
Rio de Janeiro,154,4,2,2,acept,4250,313,55,4618
Sao Paulo,240,4,3,3,acept,12000,700,153,12853
Porto Alegre,28,1,1,0,acept,1340,4,20,1364
Sao Paulo,50,1,1,0,not acept,1250,34,19,1303
Sao Paulo,180,3,3,2,acept,8000,413,102,8515
Sao Paulo,35,1,1,0,not acept,850,0,11,861
Rio de Janeiro,64,2,1,1,acept,3500,0,46,3546
Sao Paulo,60,2,1,1,acept,1310,5,17,1332
Sao Paulo,239,4,4,3,acept,5950,500,90,6540
Sao Paulo,130,3,2,1,not acept,2300,109,30,2439
Campinas,85,2,2,0,not acept,918,98,12,1028
Rio de Janeiro,75,2,2,1,acept,2000,310,26,2336
Sao Paulo,90,2,2,1,acept,1800,0,28,1828
Belo Horizonte,100,3,1,1,acept,1500,85,20,1605
Sao Paulo,70,2,2,1,not acept,1450,0,19,1469
Rio de Janeiro,86,3,1,0,acept,1258,80,17,1355
Rio de Janeiro,29,1,1,0,acept,1500,26,20,1546
Porto Alegre,82,2,2,1,acept,1700,67,25,1792
Sao Paulo,55,2,1,1,acept,1625,0,21,1646
Porto Alegre,47,1,1,1,not acept,2200,0,33,2233
Sao Paulo,33,1,1,0,not acept,4000,0,51,4051
Campinas,50,1,1,1,not acept,1800,130,23,1953
Sao Paulo,159,4,2,0,acept,1900,634,25,2559
Belo Horizonte,62,3,2,1,not acept,1100,63,15,1178
Sao Paulo,80,2,1,2,acept,1569,0,24,1593
Sao Paulo,170,3,4,3,acept,5000,450,64,5514
Porto Alegre,68,2,2,1,acept,1800,82,27,1909
Sao Paulo,300,4,4,3,acept,5080,284,77,5441
Porto Alegre,50,2,1,1,acept,1460,0,22,1482
Rio de Janeiro,80,2,2,1,acept,2000,279,26,2305
Porto Alegre,40,2,1,1,acept,820,32,12,864
Sao Paulo,270,3,4,2,acept,6500,100,83,6683
Porto Alegre,75,3,1,1,acept,1100,47,17,1164
Porto Alegre,60,1,2,2,acept,2800,17,41,2858
Sao Paulo,300,4,5,4,acept,7500,1334,96,8930
Belo Horizonte,73,2,1,2,acept,1200,62,16,1278
Belo Horizonte,85,2,1,1,acept,1000,61,14,1075
Sao Paulo,100,3,3,1,acept,2400,0,37,2437
Porto Alegre,49,1,1,0,acept,680,21,10,711
Sao Paulo,35,1,1,0,acept,1800,0,23,1823
Sao Paulo,240,3,4,1,not acept,14850,400,189,15439
Sao Paulo,45,1,1,0,acept,900,0,14,914
Sao Paulo,55,2,1,1,acept,2800,0,36,2836
Sao Paulo,305,4,3,4,acept,11000,2134,140,13274
Belo Horizonte,622,5,5,6,acept,10000,924,164,11088
Belo Horizonte,55,2,1,1,not acept,1200,67,16,1283
Rio de Janeiro,42,1,1,0,acept,2300,167,30,2497
Belo Horizonte,132,3,3,2,acept,1500,207,20,1727
Belo Horizonte,53,2,1,0,acept,850,76,12,938
Sao Paulo,998,7,10,4,acept,15000,5000,226,20226
Sao Paulo,22,1,1,0,not acept,2410,0,31,2441
Rio de Janeiro,35,1,1,0,acept,850,60,11,921
Sao Paulo,189,4,2,2,acept,8000,559,102,8661
Sao Paulo,375,4,5,3,acept,9000,850,136,9986
Sao Paulo,65,2,1,1,acept,1400,47,18,1465
Sao Paulo,462,4,6,4,acept,8000,1081,121,9202
Sao Paulo,150,2,1,0,acept,2285,100,29,2414
Campinas,350,2,2,2,acept,4300,150,65,4515
Sao Paulo,260,4,5,4,acept,7500,0,96,7596
Porto Alegre,61,1,1,0,acept,1100,160,17,1277
Sao Paulo,175,4,3,2,acept,2890,0,44,2934
Porto Alegre,70,2,1,0,acept,1800,23,27,1850
Rio de Janeiro,60,2,1,1,acept,1500,80,20,1600
Campinas,296,6,4,8,acept,5200,375,79,5654
Rio de Janeiro,96,2,2,1,not acept,2900,109,38,3047
Sao Paulo,150,4,2,3,acept,7377,800,94,8271
Sao Paulo,375,4,4,3,acept,6400,75,97,6572
Campinas,70,3,1,1,acept,1500,17,20,1537
Sao Paulo,127,4,3,2,acept,4930,472,63,5465
Belo Horizonte,67,2,2,2,not acept,2800,0,38,2838
Sao Paulo,50,1,2,1,not acept,3300,214,42,3556
Rio de Janeiro,56,2,1,0,acept,1500,0,20,1520
Sao Paulo,55,2,1,1,acept,2100,84,27,2211
Sao Paulo,34,1,1,0,not acept,900,46,14,960
Campinas,68,2,1,0,not acept,930,48,12,990
Sao Paulo,80,2,1,0,not acept,1777,0,23,1800
Campinas,120,3,1,1,not acept,1800,80,23,1903
Campinas,50,1,1,1,not acept,1600,13,21,1634
Campinas,78,2,2,1,acept,1200,127,16,1343
Rio de Janeiro,90,2,2,1,acept,3800,80,49,3929
Belo Horizonte,320,5,4,6,not acept,8000,584,132,8716
Rio de Janeiro,560,5,6,4,acept,2633,1133,34,3800
Rio de Janeiro,25,1,1,0,acept,1850,25,24,1899
Porto Alegre,37,1,1,0,acept,650,23,10,683
Rio de Janeiro,95,3,1,0,acept,3600,283,47,3930
Sao Paulo,130,3,3,2,acept,1650,414,21,2085
Belo Horizonte,270,5,4,6,acept,3910,125,53,4088
Belo Horizonte,40,1,1,0,not acept,650,59,11,720
Belo Horizonte,65,2,2,3,acept,1450,110,20,1580
Sao Paulo,45,1,1,0,not acept,1015,33,13,1061
Sao Paulo,20,1,1,0,not acept,2060,0,27,2087
Sao Paulo,720,4,5,5,acept,6500,3520,83,10103
Belo Horizonte,80,3,2,2,acept,2500,126,34,2660
Belo Horizonte,90,2,1,0,acept,1000,39,14,1053
Sao Paulo,60,1,2,0,acept,1062,1,16,1079
Belo Horizonte,45,1,1,1,not acept,3400,198,46,3644
Sao Paulo,100,1,2,0,not acept,3100,0,40,3140
Belo Horizonte,553,4,6,3,not acept,10870,1459,145,12474
Sao Paulo,250,4,3,2,acept,3900,475,59,4434
Campinas,92,3,2,3,acept,3700,299,47,4046
Sao Paulo,98,1,2,0,acept,15000,130,191,15321
Campinas,114,3,2,1,acept,1400,176,18,1594
Sao Paulo,27,1,1,1,not acept,1900,59,25,1984
Porto Alegre,225,1,2,0,acept,3500,218,63,3781
Sao Paulo,30,1,1,0,acept,1700,0,22,1722
Porto Alegre,135,3,3,4,acept,4000,0,59,4059
Campinas,150,4,3,4,not acept,4000,334,61,4395
Belo Horizonte,190,4,2,0,acept,5580,417,75,6072
Porto Alegre,47,1,1,1,not acept,2200,0,33,2233
Rio de Janeiro,120,3,1,1,acept,1150,67,18,1235
Sao Paulo,90,3,2,1,acept,2066,92,27,2185
Sao Paulo,350,4,5,2,not acept,7500,0,113,7613
Sao Paulo,160,3,4,2,acept,4300,209,65,4574
Rio de Janeiro,150,3,2,0,acept,2500,200,33,2733
Rio de Janeiro,35,1,1,0,acept,2000,86,26,2112
Porto Alegre,25,1,1,0,not acept,550,0,9,559
Sao Paulo,240,4,4,4,acept,13000,1121,165,14286
Sao Paulo,150,4,2,2,not acept,4400,37,56,4493
Rio de Janeiro,20,1,1,0,acept,700,0,10,710
Campinas,85,3,2,1,acept,1341,110,6,1457
Sao Paulo,50,2,1,1,acept,1900,0,15,1915
Sao Paulo,197,3,3,2,acept,6000,1375,77,7452
Sao Paulo,70,3,2,1,acept,2800,67,36,2903
Rio de Janeiro,220,3,2,2,acept,3500,265,46,3811
Belo Horizonte,270,4,3,2,acept,4800,241,64,5105
Porto Alegre,100,3,2,2,acept,2499,92,37,2628
Sao Paulo,195,4,6,3,acept,8000,750,102,8852
Sao Paulo,160,3,3,2,acept,4200,342,64,4606
Sao Paulo,470,4,6,3,acept,7200,1134,109,8443
Campinas,60,3,2,1,acept,1200,0,16,1216
Sao Paulo,300,4,4,3,acept,12900,584,194,13678
Sao Paulo,330,5,6,2,acept,8950,250,114,9314
Porto Alegre,109,1,2,2,acept,4300,87,63,4450
Sao Paulo,240,4,5,4,acept,12000,1000,153,13153
Sao Paulo,150,3,2,5,acept,2300,260,35,2595
Sao Paulo,200,3,2,1,acept,4500,375,58,4933
Belo Horizonte,140,4,3,1,acept,2300,167,31,2498
Sao Paulo,106,2,2,2,not acept,10600,334,135,11069
Porto Alegre,92,2,2,1,acept,2100,2610,31,4741
Sao Paulo,35,1,1,1,acept,2200,100,28,2328
Sao Paulo,70,3,2,1,acept,2900,25,37,2962
Sao Paulo,74,2,1,2,acept,6600,424,84,7108
Sao Paulo,69,2,2,2,acept,1900,210,25,2135
Sao Paulo,50,1,1,0,not acept,830,0,13,843
Porto Alegre,450,5,3,6,acept,4760,94,85,4939
Rio de Janeiro,68,2,1,0,acept,1000,400,13,1413
Sao Paulo,71,1,1,1,acept,3000,238,39,3277
Rio de Janeiro,69,2,1,1,acept,1370,56,18,1444
Belo Horizonte,32,1,1,1,acept,1500,126,20,1646
Sao Paulo,57,2,1,1,acept,1800,50,23,1873
Sao Paulo,28,1,1,0,acept,2200,72,28,2300
Sao Paulo,39,1,1,0,acept,2000,0,26,2026
Porto Alegre,140,3,3,0,acept,1700,125,25,1850
Sao Paulo,160,3,3,2,acept,4500,209,68,4777
Sao Paulo,235,3,3,1,acept,5150,575,66,5791
Sao Paulo,171,3,2,1,acept,2200,300,28,2528
Rio de Janeiro,139,3,2,2,acept,6000,540,78,6618
Belo Horizonte,160,4,3,2,acept,2300,230,31,2561
Campinas,60,2,1,1,acept,800,60,11,871
Sao Paulo,134,3,3,3,acept,2125,375,27,2527
Belo Horizonte,70,2,1,1,acept,1300,125,18,1443
Rio de Janeiro,57,2,1,0,acept,1530,0,20,1550
Sao Paulo,240,3,3,4,acept,5500,1834,70,7404
Sao Paulo,50,1,1,0,not acept,800,34,13,847
Rio de Janeiro,120,3,2,1,acept,3550,190,46,3786
Porto Alegre,200,3,3,4,acept,1200,260,18,1478
Sao Paulo,572,6,6,4,acept,7800,2359,118,10277
Sao Paulo,145,2,2,1,acept,4000,0,51,4051
Belo Horizonte,70,2,1,2,not acept,1200,97,16,1313
Rio de Janeiro,85,2,2,1,acept,8000,659,104,8763
Belo Horizonte,140,3,2,0,not acept,3000,202,40,3242
Sao Paulo,260,4,5,5,acept,12500,1667,159,14326
Sao Paulo,211,4,4,4,acept,3390,775,43,4208
Campinas,58,2,1,1,acept,650,0,9,659
Rio de Janeiro,110,1,1,2,acept,4500,341,58,4899
Sao Paulo,72,2,2,0,acept,1500,70,20,1590
Sao Paulo,700,4,7,8,acept,45000,8750,677,54427
Sao Paulo,68,1,2,1,acept,6000,229,77,6306
Rio de Janeiro,100,3,3,2,acept,2700,95,35,2830
Sao Paulo,240,3,2,0,acept,6500,444,83,7027
Rio de Janeiro,104,3,1,0,acept,3500,195,46,3741
Campinas,70,1,1,1,acept,1600,70,21,1691
Sao Paulo,67,1,1,1,acept,2600,72,33,2705
Belo Horizonte,160,4,2,5,acept,3780,167,62,4009
Belo Horizonte,64,3,1,0,not acept,1400,27,19,1446
Sao Paulo,140,3,3,5,not acept,8000,710,102,8812
Campinas,38,1,1,0,not acept,750,15,10,775
Sao Paulo,34,1,1,0,acept,2700,57,35,2792
Sao Paulo,54,2,1,0,acept,2001,0,26,2027
Sao Paulo,54,1,1,1,not acept,7200,250,92,7542
Sao Paulo,200,3,2,4,acept,3500,500,53,4053
Sao Paulo,107,3,2,2,acept,2600,350,33,2983
Rio de Janeiro,70,2,2,0,acept,1550,77,20,1647
Sao Paulo,20,1,1,0,acept,1800,130,23,1953
Sao Paulo,86,2,1,1,acept,2340,0,8,2348
Rio de Janeiro,30,1,1,1,acept,1480,25,20,1525
Porto Alegre,108,3,2,1,acept,2000,89,30,2119
Sao Paulo,250,4,3,4,acept,2700,154,41,2895
Sao Paulo,80,2,1,0,acept,2200,92,28,2320
Rio de Janeiro,73,2,1,1,acept,1100,0,15,1115
Porto Alegre,45,1,1,1,acept,1205,72,18,1295
Sao Paulo,45,2,2,0,not acept,1650,84,25,1759
Sao Paulo,255,4,4,0,acept,2500,1484,32,4016
Belo Horizonte,217,4,3,4,acept,6000,1177,80,7257
Sao Paulo,70,1,1,0,acept,1870,0,24,1894
Sao Paulo,25,1,1,0,not acept,885,0,12,897
Porto Alegre,110,3,3,0,acept,3250,75,48,3373
Sao Paulo,80,2,2,1,acept,10000,109,127,10236
Sao Paulo,260,3,5,0,acept,9000,634,136,9770
Sao Paulo,50,2,2,1,acept,2700,82,35,2817
Campinas,60,2,1,1,not acept,815,20,6,841
Sao Paulo,400,3,6,6,acept,6500,375,98,6973
Sao Paulo,113,2,1,1,acept,3000,50,39,3089
Sao Paulo,400,4,4,6,acept,8000,1750,102,9852
Porto Alegre,64,2,2,2,acept,2250,50,33,2333
Sao Paulo,82,2,1,2,acept,3100,333,40,3473
Sao Paulo,65,2,1,3,acept,2000,217,26,2243
Porto Alegre,128,4,3,2,acept,4900,409,88,5397
Sao Paulo,38,1,1,0,not acept,950,0,13,963
Campinas,175,3,2,0,not acept,2000,0,31,2031
Sao Paulo,107,3,3,2,acept,4500,417,58,4975
Rio de Janeiro,257,4,3,2,acept,3800,709,49,4558
Sao Paulo,35,1,1,1,not acept,3250,30,42,3322
Sao Paulo,463,4,7,6,acept,12000,1264,181,13445
Rio de Janeiro,40,2,1,0,acept,920,55,12,987
Belo Horizonte,297,4,2,3,acept,1870,209,15,2094
Sao Paulo,137,3,3,1,acept,5500,303,70,5873
Rio de Janeiro,35,1,1,0,not acept,1200,80,16,1296
Rio de Janeiro,128,3,3,1,acept,3500,242,46,3788
Belo Horizonte,59,2,1,1,acept,1250,70,17,1337
Rio de Janeiro,400,4,4,2,acept,11480,1357,175,13012
Rio de Janeiro,100,3,2,1,not acept,4500,125,58,4683
Rio de Janeiro,50,1,1,0,acept,2200,85,29,2314
Porto Alegre,80,2,2,1,acept,1900,120,28,2048
Belo Horizonte,68,2,2,2,acept,1650,154,22,1826
Sao Paulo,32,1,1,1,acept,2000,416,26,2442
Rio de Janeiro,161,3,3,3,acept,4500,640,58,5198
Sao Paulo,85,2,2,0,acept,1700,0,26,1726
Sao Paulo,100,2,2,0,acept,2500,274,38,2812
Sao Paulo,136,3,4,3,acept,5000,117,64,5181
Sao Paulo,362,4,5,2,acept,7000,834,106,7940
Sao Paulo,276,3,3,4,acept,6500,1650,83,8233
Rio de Janeiro,22,1,1,0,not acept,1322,59,16,1397
Porto Alegre,60,2,1,0,acept,980,42,15,1037
Sao Paulo,500,4,7,8,acept,9250,1167,140,10557
Porto Alegre,65,1,1,1,acept,980,38,15,1033
Sao Paulo,56,2,1,1,acept,2600,0,33,2633
Sao Paulo,35,1,1,1,not acept,2840,10,36,2886
Porto Alegre,98,3,2,2,not acept,2550,100,38,2688
Sao Paulo,45,1,1,0,not acept,950,30,15,995
Porto Alegre,48,2,1,1,acept,800,35,12,847
Campinas,48,1,1,1,acept,1500,42,20,1562
Sao Paulo,114,2,3,1,acept,7010,167,89,7266
Belo Horizonte,197,4,2,3,acept,4250,400,57,4707
Belo Horizonte,200,4,1,2,acept,2500,209,34,2743
Belo Horizonte,110,3,2,0,acept,2500,0,41,2541
Sao Paulo,300,2,4,2,acept,6000,419,91,6510
Belo Horizonte,120,3,1,1,not acept,1900,140,26,2066
Porto Alegre,40,1,1,0,acept,1084,46,16,1146
Sao Paulo,92,2,1,1,not acept,3950,0,51,4001
Sao Paulo,140,3,2,2,acept,5500,583,70,6153
Sao Paulo,244,4,3,4,acept,7000,1000,89,8089
Porto Alegre,59,2,1,0,acept,1000,42,15,1057
Rio de Janeiro,35,1,1,0,acept,791,30,11,832
Sao Paulo,120,3,2,3,acept,2000,292,26,2318
Sao Paulo,248,4,5,4,not acept,9100,250,116,9466
Sao Paulo,63,2,2,1,acept,1690,27,22,1739
Sao Paulo,45,1,1,1,acept,1800,172,23,1995
Sao Paulo,129,2,3,2,acept,2376,334,38,2748
Sao Paulo,300,3,3,8,acept,4675,400,71,5146
Sao Paulo,29,1,1,1,not acept,2200,118,28,2346
Belo Horizonte,100,3,2,1,acept,1300,119,18,1437
Sao Paulo,153,4,3,3,acept,5500,700,70,6270
Campinas,87,2,1,1,acept,1200,52,16,1268
Sao Paulo,75,1,1,2,acept,7000,323,89,7412
Rio de Janeiro,300,4,4,2,acept,12750,1334,165,14249
Porto Alegre,48,1,1,0,acept,700,300,11,1011
Sao Paulo,56,2,2,1,acept,2000,0,26,2026
Campinas,71,2,1,1,acept,977,114,13,1104
Sao Paulo,84,4,1,3,not acept,6000,804,77,6881
Sao Paulo,208,3,4,3,not acept,3490,476,53,4019
Sao Paulo,100,1,2,1,not acept,6000,348,77,6425
Sao Paulo,84,3,2,2,acept,2200,71,28,2299
Sao Paulo,145,4,3,2,acept,4800,500,61,5361
Sao Paulo,300,4,3,2,acept,15000,1040,226,16266
Sao Paulo,65,2,2,1,not acept,6000,250,77,6327
Sao Paulo,27,1,1,0,not acept,836,0,13,849
Rio de Janeiro,102,3,2,1,acept,1350,140,18,1508
Campinas,60,2,1,1,not acept,2848,64,37,2949
Porto Alegre,60,1,1,0,acept,1286,70,19,1375
Rio de Janeiro,50,1,1,0,acept,1620,0,21,1641
Sao Paulo,97,3,1,1,acept,2300,25,30,2355
Sao Paulo,52,1,2,1,acept,5000,210,64,5274
Sao Paulo,373,4,4,3,acept,12750,1417,162,14329
Sao Paulo,157,4,3,2,acept,6608,492,100,7200
Campinas,68,3,1,1,acept,1100,50,14,1164
Sao Paulo,172,4,4,3,acept,8800,890,112,9802
Sao Paulo,64,2,2,2,not acept,3500,0,45,3545
Rio de Janeiro,41,1,1,0,acept,1700,85,22,1807
Rio de Janeiro,106,2,2,1,acept,2850,296,37,3183
Belo Horizonte,150,4,2,3,acept,3300,340,44,3684
Belo Horizonte,135,4,2,2,acept,3500,117,47,3664
Sao Paulo,350,4,6,6,acept,9600,1367,145,11112
Belo Horizonte,360,3,1,3,acept,1500,142,25,1667
Sao Paulo,700,4,7,8,acept,15000,2250,226,17476
Rio de Janeiro,100,2,2,1,acept,8900,380,115,9395
Belo Horizonte,50,1,1,2,acept,1200,0,16,1216
Sao Paulo,55,3,1,1,acept,1300,0,17,1317
Sao Paulo,215,4,4,2,not acept,6000,834,77,6911
Sao Paulo,287,3,2,5,acept,15000,0,226,15226
Sao Paulo,58,2,1,1,acept,1500,43,20,1563
Sao Paulo,90,3,2,2,acept,1600,300,21,1921
Sao Paulo,200,3,3,3,acept,3315,241,50,3606
Sao Paulo,65,3,2,1,acept,2200,5,28,2233
Sao Paulo,820,4,6,6,acept,10000,2500,151,12651
Sao Paulo,102,2,1,0,acept,2000,109,26,2135
Rio de Janeiro,108,3,2,2,acept,4500,442,58,5000
Sao Paulo,86,3,2,2,acept,3100,203,40,3343
Campinas,210,6,3,0,acept,4200,0,64,4264
Belo Horizonte,140,4,2,2,acept,4200,462,56,4718
Sao Paulo,220,4,4,3,acept,4500,1042,58,5600
Campinas,66,2,1,1,acept,1100,34,14,1148
Sao Paulo,389,4,5,6,acept,8500,1834,108,10442
Sao Paulo,80,3,3,1,not acept,1700,25,22,1747
Sao Paulo,78,2,2,1,acept,2200,148,28,2376
Sao Paulo,178,4,2,5,acept,6000,459,91,6550
Sao Paulo,47,2,1,1,acept,1140,64,15,1219
Belo Horizonte,160,4,1,1,acept,2150,0,36,2186
Rio de Janeiro,25,1,1,0,acept,700,0,10,710
Sao Paulo,80,2,2,2,acept,1700,177,26,1903
Sao Paulo,144,3,3,2,acept,5000,109,76,5185
Campinas,400,5,7,4,acept,7900,888,101,8889
Belo Horizonte,100,3,2,1,acept,14500,423,238,15161
Sao Paulo,48,2,1,0,acept,1150,90,15,1255
Sao Paulo,64,3,2,2,acept,1530,34,20,1584
Porto Alegre,50,2,1,0,acept,700,100,11,811
Sao Paulo,50,1,1,1,acept,5156,117,66,5339
Sao Paulo,60,2,2,1,acept,1465,100,19,1584
Rio de Janeiro,180,3,2,1,acept,4800,377,62,5239
Sao Paulo,339,3,3,4,acept,3880,353,59,4292
Campinas,54,1,1,1,acept,2350,127,30,2507
Sao Paulo,420,4,6,4,acept,12000,3167,153,15320
Campinas,350,4,5,4,acept,8000,417,121,8538
Sao Paulo,72,2,2,2,not acept,3060,250,39,3349
Sao Paulo,50,1,1,0,not acept,800,59,13,872
Sao Paulo,450,4,4,4,acept,11000,1417,166,12583
Rio de Janeiro,60,2,1,0,not acept,2900,92,38,3030
Sao Paulo,160,2,3,3,acept,7500,417,113,8030
Belo Horizonte,450,4,4,5,not acept,13500,1130,180,14810
Sao Paulo,265,3,4,3,acept,3490,450,53,3993
Sao Paulo,103,3,1,3,acept,3400,94,44,3538
Sao Paulo,60,2,2,1,acept,1650,0,21,1671
Sao Paulo,136,3,3,3,acept,7900,490,101,8491
Belo Horizonte,45,2,1,1,not acept,750,28,10,788
Sao Paulo,206,3,3,4,acept,12500,758,159,13417
Sao Paulo,229,4,2,3,acept,5500,409,70,5979
Campinas,70,1,2,1,not acept,1000,35,13,1048
Sao Paulo,130,3,2,0,acept,4500,574,58,5132
Campinas,87,2,1,0,acept,1100,82,14,1196
Sao Paulo,200,4,5,3,not acept,6000,250,77,6327
Rio de Janeiro,50,1,1,1,acept,1320,0,18,1338
Sao Paulo,120,3,2,1,acept,3000,495,46,3541
Sao Paulo,40,1,1,0,not acept,1300,111,17,1428
Sao Paulo,54,2,1,1,acept,1800,129,23,1952
Sao Paulo,48,2,1,0,acept,1350,0,18,1368
Sao Paulo,149,3,4,3,acept,6000,550,77,6627
Sao Paulo,45,2,1,1,acept,1500,82,20,1602
Sao Paulo,76,2,2,2,not acept,2650,130,34,2814
Sao Paulo,60,2,1,0,acept,1850,0,24,1874
Sao Paulo,118,3,3,2,not acept,9000,352,115,9467
Sao Paulo,200,2,3,1,not acept,13000,625,165,13790
Sao Paulo,200,2,2,1,acept,5000,0,76,5076
Sao Paulo,138,3,4,2,acept,10000,527,127,10654
Sao Paulo,53,2,1,1,acept,1200,0,16,1216
Porto Alegre,61,1,1,1,acept,3800,104,56,3960
Sao Paulo,135,3,3,2,not acept,2800,641,36,3477
Sao Paulo,50,1,1,0,not acept,750,25,12,787
Sao Paulo,34,1,1,1,not acept,1300,100,17,1417
Sao Paulo,218,3,3,3,not acept,4000,775,51,4826
Sao Paulo,400,3,5,4,acept,10000,1250,127,11377
Belo Horizonte,25,1,1,1,not acept,550,84,8,642
Porto Alegre,360,5,3,3,acept,3500,0,63,3563
Sao Paulo,72,2,1,1,acept,2630,378,34,3042
Sao Paulo,45,2,1,1,acept,1600,34,21,1655
Belo Horizonte,340,3,5,5,acept,4600,211,76,4887
Sao Paulo,130,3,3,2,acept,3100,130,47,3277
Sao Paulo,72,3,2,2,acept,3000,245,39,3284
Sao Paulo,50,1,1,0,not acept,900,0,14,914
Sao Paulo,100,2,2,0,not acept,4999,50,64,5113
Sao Paulo,270,3,2,4,acept,13000,1250,165,14415
Belo Horizonte,60,2,1,1,acept,1325,0,18,1343
Belo Horizonte,46335,4,8,5,acept,8500,646,114,9260
Belo Horizonte,700,3,3,8,acept,10000,807,164,10971
Sao Paulo,550,4,5,0,acept,8800,0,112,8912
Belo Horizonte,21,1,1,1,not acept,980,0,14,994
Sao Paulo,55,1,2,1,acept,3800,100,49,3949
Sao Paulo,40,1,2,1,not acept,4200,318,54,4572
Belo Horizonte,50,1,1,1,not acept,1500,100,20,1620
Sao Paulo,52,1,1,1,acept,3950,290,51,4291
Sao Paulo,46,2,1,1,acept,1434,9,19,1462
Belo Horizonte,20,1,1,1,acept,1100,0,15,1115
Sao Paulo,50,1,1,0,acept,1050,59,16,1125
Rio de Janeiro,49,1,2,1,acept,2400,133,31,2564
Porto Alegre,440,3,2,3,not acept,10500,84,154,10738
Porto Alegre,59,2,1,1,acept,900,62,14,976
Belo Horizonte,150,4,1,3,acept,2300,0,38,2338
Sao Paulo,100,3,2,0,acept,2020,132,26,2178
Sao Paulo,72,2,2,1,acept,2100,27,27,2154
Sao Paulo,500,7,7,8,not acept,9000,1667,136,10803
Sao Paulo,264,3,5,0,acept,6000,488,91,6579
Sao Paulo,76,2,2,2,acept,5500,299,70,5869
Sao Paulo,16,1,1,0,not acept,870,0,12,882
Sao Paulo,198,3,2,2,acept,3250,334,42,3626
Sao Paulo,190,3,2,1,acept,4000,100,51,4151
Sao Paulo,210,4,4,4,not acept,11500,1480,146,13126
Campinas,233,3,1,1,acept,2700,239,41,2980
Sao Paulo,180,3,2,2,acept,11000,150,166,11316
Belo Horizonte,1020,5,4,6,acept,6520,654,107,7281
Sao Paulo,320,3,3,2,acept,7200,600,109,7909
Sao Paulo,116,3,2,2,acept,3800,518,49,4367
Sao Paulo,128,2,1,1,acept,8500,9,108,8617
Campinas,42,2,1,1,acept,1020,0,13,1033
Sao Paulo,70,2,1,1,acept,3800,45,49,3894
Sao Paulo,320,3,4,4,acept,15000,1659,191,16850
Campinas,77,2,2,1,acept,1200,71,16,1287
Sao Paulo,208,3,3,3,acept,15000,1200,191,16391
Sao Paulo,115,3,3,3,acept,2400,71,37,2508
Porto Alegre,60,2,1,1,acept,1300,25,19,1344
Porto Alegre,50,1,1,0,acept,1045,30,16,1091
Sao Paulo,108,2,4,2,acept,4500,522,58,5080
Sao Paulo,64,2,2,1,not acept,6950,276,89,7315
Sao Paulo,178,3,2,1,acept,3500,130,53,3683
Porto Alegre,53,1,1,0,acept,1480,42,22,1544
Rio de Janeiro,118,3,2,0,acept,1560,210,21,1791
Campinas,65,2,1,1,acept,1250,53,16,1319
Rio de Janeiro,180,3,3,2,acept,7000,475,91,7566
Campinas,348,3,3,3,acept,4850,400,73,5323
Sao Paulo,150,3,3,1,not acept,4500,484,58,5042
Porto Alegre,45,1,1,0,acept,650,28,10,688
Sao Paulo,37,1,1,1,not acept,3300,13,42,3355
Sao Paulo,540,4,4,6,acept,5220,1542,79,6841
Belo Horizonte,521,5,2,3,acept,10000,743,164,10907
Campinas,147,4,3,3,acept,4800,284,61,5145
Rio de Janeiro,130,3,2,1,acept,2610,450,34,3094
Sao Paulo,190,3,2,1,acept,3700,0,56,3756
Rio de Janeiro,28,1,1,0,acept,730,99,10,839
Sao Paulo,160,3,3,3,not acept,5850,528,88,6466
Rio de Janeiro,310,3,2,0,acept,5200,595,68,5863
Sao Paulo,530,4,5,6,not acept,13000,0,196,13196
Sao Paulo,59,2,1,1,acept,1200,0,16,1216
Sao Paulo,800,5,4,8,acept,14200,2250,214,16664
Sao Paulo,77,2,1,0,acept,2050,7,26,2083
Sao Paulo,160,3,2,1,acept,4300,500,55,4855
Sao Paulo,47,1,1,1,acept,1800,0,23,1823
Belo Horizonte,52,2,1,1,acept,1000,0,14,1014
Sao Paulo,60,1,2,1,acept,4000,112,51,4163
Rio de Janeiro,120,3,3,2,acept,3000,500,39,3539
Belo Horizonte,55,2,1,0,not acept,850,50,12,912
Campinas,110,3,3,2,acept,3200,88,49,3337
Porto Alegre,145,3,4,0,acept,2950,75,44,3069
Sao Paulo,88,2,4,2,acept,2300,379,30,2709
Sao Paulo,49,2,1,1,acept,2000,3,26,2029
Sao Paulo,26,1,1,0,acept,3500,80,45,3625
Sao Paulo,36,1,1,0,acept,1600,60,21,1681
Sao Paulo,150,3,2,5,acept,2100,260,32,2392
Sao Paulo,77,1,1,1,not acept,5700,0,73,5773
Campinas,60,1,1,2,acept,1610,50,25,1685
Rio de Janeiro,58,2,2,1,acept,1190,105,16,1311
Sao Paulo,145,4,4,3,acept,4500,584,58,5142
Sao Paulo,408,4,6,3,acept,15000,1667,191,16858
Sao Paulo,50,1,1,0,acept,800,18,13,831
Sao Paulo,85,3,2,2,acept,3300,116,42,3458
Belo Horizonte,210,3,3,3,acept,4200,242,56,4498
Belo Horizonte,100,3,1,2,acept,1646,73,22,1741
Porto Alegre,68,2,1,1,not acept,1900,78,28,2006
Campinas,42,1,1,1,not acept,2000,75,26,2101
Campinas,87,3,1,0,acept,1300,105,17,1422
Sao Paulo,40,1,1,0,acept,950,84,13,1047
Sao Paulo,50,2,1,1,acept,1850,133,24,2007
Porto Alegre,85,2,2,0,acept,2520,113,37,2670
Porto Alegre,55,1,1,1,acept,1910,110,28,2048
Sao Paulo,127,2,2,2,acept,5500,361,70,5931
Sao Paulo,172,3,5,3,acept,5800,607,88,6495
Porto Alegre,75,2,1,2,acept,1200,55,18,1273
Sao Paulo,50,1,1,1,not acept,3000,123,39,3162
Campinas,120,4,2,5,acept,4200,0,64,4264
Sao Paulo,95,3,2,2,acept,3490,167,45,3702
Belo Horizonte,300,5,3,6,acept,5200,334,86,5620
Rio de Janeiro,44,1,1,0,acept,1600,0,21,1621
Porto Alegre,563,3,6,4,acept,15000,1250,220,16470
Rio de Janeiro,65,2,2,0,not acept,1700,84,22,1806
Rio de Janeiro,170,2,2,1,acept,2940,80,38,3058
Belo Horizonte,22,1,1,1,not acept,1500,0,20,1520
Belo Horizonte,410,4,4,4,acept,4900,466,81,5447
Rio de Janeiro,60,2,1,1,acept,1400,41,19,1460
Sao Paulo,47,1,1,0,acept,2700,178,35,2913
Sao Paulo,72,2,2,0,acept,1500,70,20,1590
Belo Horizonte,157,4,3,3,acept,9000,108,120,9228
Sao Paulo,280,3,4,2,acept,7000,584,106,7690
Rio de Janeiro,68,3,2,1,acept,1050,82,14,1146
Campinas,56,1,1,0,not acept,560,17,9,586
Sao Paulo,140,2,4,1,acept,8900,300,113,9313
Campinas,50,2,1,0,not acept,830,55,11,896
Campinas,40,2,1,1,acept,1200,70,16,1286
Sao Paulo,260,3,4,4,acept,12000,0,153,12153
Sao Paulo,700,6,8,8,acept,14000,1020,211,15231
Sao Paulo,130,2,1,0,acept,1900,292,29,2221
Sao Paulo,215,3,2,0,not acept,4000,229,51,4280
Rio de Janeiro,300,4,3,2,acept,4500,796,58,5354
Sao Paulo,250,4,5,4,acept,12000,1667,153,13820
Rio de Janeiro,80,2,2,1,acept,5435,207,71,5713
Porto Alegre,54,2,1,0,acept,1200,41,18,1259
Campinas,57,1,2,1,not acept,650,0,9,659
Sao Paulo,130,3,2,1,not acept,4500,0,58,4558
Sao Paulo,48,1,1,2,not acept,6800,400,87,7287
Porto Alegre,318,4,3,0,acept,19000,384,338,19722
Sao Paulo,77,1,2,1,acept,7740,209,99,8048
Sao Paulo,42,1,1,1,acept,2650,243,34,2927
Rio de Janeiro,74,3,1,0,acept,1600,40,25,1665
Sao Paulo,452,4,6,4,acept,9980,2500,127,12607
Porto Alegre,41,1,2,1,acept,2400,67,36,2503
Sao Paulo,90,2,2,2,acept,1917,275,25,2217
Rio de Janeiro,145,1,3,1,not acept,8000,537,104,8641
Sao Paulo,70,1,2,0,acept,2035,111,26,2172
Sao Paulo,180,3,4,5,acept,3300,266,50,3616
Sao Paulo,68,2,1,0,acept,1300,50,17,1367
Sao Paulo,300,4,4,3,acept,10000,767,151,10918
Sao Paulo,270,3,3,1,acept,6500,23,98,6621
Sao Paulo,63,1,1,1,acept,650,0,9,659
Sao Paulo,140,2,3,1,acept,5000,250,64,5314
Sao Paulo,220,5,4,3,not acept,8000,425,121,8546
Sao Paulo,90,3,2,2,acept,2500,355,32,2887
Sao Paulo,62,2,2,1,not acept,3200,129,41,3370
Sao Paulo,55,1,1,0,not acept,770,0,10,780
Belo Horizonte,170,3,2,3,acept,4000,180,66,4246
Belo Horizonte,75,3,2,1,acept,1100,90,15,1205
Sao Paulo,150,3,4,3,acept,2490,375,32,2897
Porto Alegre,270,4,4,2,acept,7000,200,125,7325
Porto Alegre,55,2,1,0,not acept,1500,27,22,1549
Rio de Janeiro,38,1,1,0,not acept,1050,0,14,1064
Porto Alegre,87,2,2,1,acept,1970,117,29,2116
Belo Horizonte,26,1,1,1,acept,750,67,10,827
Belo Horizonte,384,5,4,6,not acept,5000,435,82,5517
Belo Horizonte,62,2,1,1,acept,1050,84,14,1148
Sao Paulo,70,2,1,1,acept,1750,50,23,1823
Porto Alegre,48,1,1,1,acept,1288,0,19,1307
Sao Paulo,396,4,4,4,acept,10000,750,151,10901
Rio de Janeiro,480,3,4,1,acept,7000,1201,91,8292
Belo Horizonte,230,4,4,3,acept,6300,431,84,6815
Rio de Janeiro,60,1,1,0,acept,2210,84,29,2323
Rio de Janeiro,80,2,2,2,acept,1900,420,25,2345
Rio de Janeiro,150,4,3,3,acept,7500,525,97,8122
Belo Horizonte,85,3,1,0,not acept,1100,150,15,1265
Sao Paulo,25,1,1,0,acept,2200,60,28,2288
Porto Alegre,105,3,3,0,acept,2125,111,32,2268
Sao Paulo,144,4,2,2,acept,4800,667,61,5528
Belo Horizonte,80,3,2,2,acept,2600,164,35,2799
Sao Paulo,100,1,1,0,acept,1530,84,23,1637
Belo Horizonte,649,5,5,6,acept,15000,1065,246,16311
Porto Alegre,55,2,1,1,acept,850,30,13,893
Porto Alegre,68,2,2,1,acept,1800,82,27,1909
Sao Paulo,265,3,3,0,acept,8500,475,128,9103
Sao Paulo,96,2,1,0,acept,4387,3,56,4446
Belo Horizonte,241,5,4,3,acept,5200,310,86,5596
Rio de Janeiro,65,2,1,1,acept,900,88,12,1000
Campinas,71,2,1,1,acept,1130,114,15,1259
Sao Paulo,90,1,1,0,not acept,1550,167,20,1737
Sao Paulo,90,3,2,0,acept,2100,84,27,2211
Campinas,42,1,1,1,acept,1020,42,13,1075
Porto Alegre,109,3,1,1,acept,1400,42,21,1463
Rio de Janeiro,260,4,1,2,acept,15000,1167,194,16361
Sao Paulo,154,3,3,2,acept,2000,0,26,2026
Belo Horizonte,55,1,1,0,not acept,1020,21,17,1058
Sao Paulo,49,2,2,1,acept,2400,55,31,2486
Sao Paulo,56,1,1,0,acept,8000,280,102,8382
Campinas,67,2,1,1,acept,1230,42,16,1288
Sao Paulo,160,4,4,0,acept,3175,787,41,4003
Porto Alegre,118,3,2,1,acept,1800,50,27,1877
Belo Horizonte,47,2,1,1,acept,1480,75,20,1575
Sao Paulo,132,3,4,3,not acept,2980,520,38,3538
Porto Alegre,47,1,1,0,acept,755,27,12,794
Campinas,60,3,2,1,not acept,1700,120,22,1842
Sao Paulo,250,4,5,0,acept,7880,1566,100,9546
Porto Alegre,400,3,4,5,acept,8500,309,152,8961
Rio de Janeiro,28,1,1,0,acept,2200,0,29,2229
Sao Paulo,300,3,4,2,acept,14000,1084,178,15262
Sao Paulo,78,2,1,2,acept,5900,0,75,5975
Sao Paulo,56,2,1,0,acept,1800,41,23,1864
Sao Paulo,110,2,2,0,acept,3360,248,43,3651
Sao Paulo,65,2,2,1,acept,1800,25,23,1848
Belo Horizonte,59,3,1,1,acept,1018,63,14,1095
Sao Paulo,20,1,1,0,acept,1800,130,23,1953
Sao Paulo,65,3,1,1,acept,1800,0,23,1823
Sao Paulo,235,4,4,4,acept,14900,1417,189,16506
Sao Paulo,137,2,3,2,acept,14000,542,178,14720
Belo Horizonte,28,1,1,0,not acept,1100,0,15,1115
Sao Paulo,50,1,1,1,not acept,1500,80,23,1603
Sao Paulo,120,3,1,4,acept,3500,234,53,3787
Sao Paulo,80,2,1,0,not acept,1576,125,24,1725
Rio de Janeiro,82,3,1,0,not acept,2700,50,35,2785
Sao Paulo,160,3,2,1,acept,4700,0,71,4771
Sao Paulo,51,1,1,0,acept,2350,150,30,2530
Sao Paulo,56,2,1,0,acept,1400,0,10,1410
Sao Paulo,170,3,4,0,acept,4000,800,51,4851
Sao Paulo,300,4,5,4,acept,3800,1630,49,5479
Sao Paulo,60,2,1,1,acept,3400,23,44,3467
Rio de Janeiro,50,1,1,1,acept,990,19,13,1022
Sao Paulo,250,5,6,2,acept,9000,717,136,9853
Rio de Janeiro,80,2,2,2,acept,935,100,13,1048
Sao Paulo,20,1,1,0,acept,1800,130,23,1953
Rio de Janeiro,110,2,1,1,not acept,3800,250,49,4099
Belo Horizonte,430,4,5,3,acept,6000,0,99,6099
Belo Horizonte,144,4,3,3,not acept,4500,390,60,4950
Sao Paulo,80,2,1,1,acept,24000,0,305,24305
Campinas,30,1,1,0,acept,580,12,8,600
Sao Paulo,163,2,3,2,acept,8000,470,102,8572
Belo Horizonte,80,2,2,2,acept,2600,113,35,2748
Sao Paulo,300,5,4,7,acept,15000,2292,226,17518
Belo Horizonte,544,4,3,7,acept,3200,250,53,3503
Belo Horizonte,95,3,2,2,not acept,1800,134,24,1958
Porto Alegre,65,2,1,0,acept,1030,24,16,1070
Belo Horizonte,305,4,5,5,acept,14000,2241,187,16428
Belo Horizonte,103,2,2,2,not acept,1200,100,16,1316
Sao Paulo,135,3,2,2,acept,2300,775,30,3105
Sao Paulo,200,3,4,2,acept,7000,677,89,7766
Rio de Janeiro,47,2,2,1,acept,1000,40,13,1053
Rio de Janeiro,35,1,1,0,acept,700,80,10,790
Campinas,44,2,1,1,acept,1000,0,13,1013
Sao Paulo,82,2,1,1,acept,3400,0,44,3444
Sao Paulo,50,1,1,1,not acept,900,21,14,935
Belo Horizonte,360,4,3,3,acept,3300,171,55,3526
Porto Alegre,95,3,2,2,acept,2500,71,37,2608
Sao Paulo,83,2,3,2,acept,3200,735,41,3976
Sao Paulo,60,1,1,1,acept,2100,0,27,2127
Sao Paulo,122,3,2,1,acept,5800,279,74,6153
Sao Paulo,150,3,4,4,acept,7925,651,101,8677
Campinas,450,5,4,8,acept,3460,400,53,3913
Porto Alegre,58,2,1,1,acept,1000,47,15,1062
Sao Paulo,380,4,2,4,acept,4600,700,70,5370
Belo Horizonte,430,4,5,3,acept,8000,528,107,8635
Porto Alegre,280,3,5,2,acept,5280,500,78,5858
Belo Horizonte,580,5,6,5,not acept,15000,1153,246,16399
Porto Alegre,98,2,2,0,acept,1100,38,17,1155
Sao Paulo,40,1,1,1,not acept,1080,65,14,1159
Rio de Janeiro,50,2,1,1,not acept,2300,0,30,2330
Sao Paulo,40,1,1,1,acept,4065,202,52,4319
Rio de Janeiro,75,4,4,1,not acept,4500,0,58,4558
Rio de Janeiro,72,1,1,1,acept,3500,239,46,3785
Sao Paulo,429,5,4,6,acept,12750,2312,192,15254
Sao Paulo,380,4,2,0,acept,8000,0,121,8121
Belo Horizonte,72,3,1,1,not acept,900,86,12,998
Sao Paulo,114,3,3,0,acept,2600,171,40,2811
Sao Paulo,100,3,2,4,acept,3880,255,59,4194
Sao Paulo,120,4,2,2,acept,4000,464,51,4515
Sao Paulo,100,3,3,2,acept,5500,250,70,5820
Porto Alegre,170,2,3,2,acept,6500,292,116,6908
Sao Paulo,62,1,2,1,acept,12000,350,153,12503
Sao Paulo,62,2,2,1,acept,2500,158,32,2690
Sao Paulo,94,2,3,2,not acept,4400,325,56,4781
Rio de Janeiro,144,3,2,1,acept,8200,622,106,8928
Campinas,68,2,1,2,acept,1200,74,16,1290
Porto Alegre,42,1,1,0,not acept,2200,66,33,2299
Porto Alegre,84,3,1,0,acept,1460,44,22,1526
Sao Paulo,165,3,4,4,acept,10000,799,127,10926
Sao Paulo,50,2,1,1,acept,1072,0,14,1086
Porto Alegre,65,2,1,1,not acept,1750,100,26,1876
Campinas,52,1,1,1,not acept,2300,50,30,2380
Sao Paulo,136,3,3,2,acept,3400,115,44,3559
Belo Horizonte,75,2,1,1,not acept,1100,62,15,1177
Sao Paulo,212,3,5,3,acept,7000,1084,89,8173
Sao Paulo,70,2,1,1,acept,1400,52,18,1470
Sao Paulo,57,2,1,1,acept,2300,63,30,2393
Sao Paulo,128,2,3,3,acept,3900,500,50,4450
Sao Paulo,62,2,2,1,not acept,2350,0,30,2380
Sao Paulo,140,3,3,2,acept,3800,200,58,4058
Sao Paulo,55,2,1,1,acept,1399,0,18,1417
Sao Paulo,130,3,2,1,acept,5500,209,70,5779
Sao Paulo,82,3,2,2,not acept,2600,209,33,2842
Sao Paulo,100,3,2,1,acept,1200,38,16,1254
Sao Paulo,122,2,2,2,acept,3950,640,51,4641
Porto Alegre,87,2,1,0,acept,1300,64,19,1383
Belo Horizonte,70,2,1,2,acept,780,0,11,791
Rio de Janeiro,123,3,2,1,acept,3700,237,48,3985
Porto Alegre,91,3,2,2,acept,3390,150,50,3590
Sao Paulo,50,1,1,0,acept,1100,0,14,1114
Sao Paulo,189,4,3,3,acept,5780,440,74,6294
Campinas,45,2,1,1,acept,850,25,11,886
Rio de Janeiro,35,1,1,0,acept,1950,50,26,2026
Sao Paulo,350,5,5,4,not acept,7200,1417,92,8709
Belo Horizonte,73,1,1,0,not acept,1460,142,20,1622
Sao Paulo,35,2,1,1,acept,2100,0,32,2132
Sao Paulo,685,4,3,5,acept,13000,3120,165,16285
Sao Paulo,140,5,2,1,acept,3999,200,51,4250
Sao Paulo,78,3,3,2,acept,2800,117,36,2953
Sao Paulo,200,6,4,2,acept,5600,4710,85,10395
Porto Alegre,102,2,2,1,acept,3000,259,44,3303
Campinas,48,2,1,1,acept,1000,66,13,1079
Sao Paulo,84,3,2,1,not acept,2175,185,28,2388
Sao Paulo,80,2,1,1,acept,1300,40,20,1360
Sao Paulo,391,4,5,2,acept,10000,1999,127,12126
Sao Paulo,227,4,4,3,not acept,15000,750,191,15941
Sao Paulo,180,3,3,4,acept,6500,859,83,7442
Belo Horizonte,178,4,4,4,acept,3900,409,52,4361
Sao Paulo,105,1,1,2,not acept,8700,417,111,9228
Sao Paulo,26,1,1,0,acept,4300,60,55,4415
Sao Paulo,200,2,3,1,acept,4500,0,58,4558
Belo Horizonte,78,2,2,2,acept,1300,100,18,1418
Sao Paulo,309,4,5,3,acept,12000,734,181,12915
Porto Alegre,66,3,2,1,acept,1500,40,22,1562
Rio de Janeiro,20,1,1,0,not acept,1650,0,22,1672
Campinas,35,1,1,1,acept,750,32,10,792
Sao Paulo,130,2,4,3,acept,6000,667,77,6744
Sao Paulo,120,3,1,0,acept,1210,207,16,1433
Rio de Janeiro,75,2,2,0,not acept,2200,59,29,2288
Sao Paulo,120,3,3,2,not acept,7300,400,93,7793
Rio de Janeiro,65,2,1,1,acept,1530,0,20,1550
Sao Paulo,20,1,1,0,acept,1800,130,23,1953
Sao Paulo,62,3,1,2,acept,1400,156,18,1574
Sao Paulo,129,3,4,2,acept,3000,600,39,3639
Sao Paulo,70,2,2,4,acept,3000,190,46,3236
Rio de Janeiro,38,1,1,0,not acept,1700,82,22,1804
Porto Alegre,120,3,3,3,acept,5000,0,74,5074
Sao Paulo,180,2,3,2,acept,3150,301,48,3499
Sao Paulo,82,1,1,2,acept,8000,267,102,8369
Belo Horizonte,58,2,2,2,acept,1400,100,19,1519
Sao Paulo,52,2,1,1,not acept,2400,78,31,2509
Sao Paulo,67,2,1,0,acept,1300,56,17,1373
Belo Horizonte,100,3,1,1,acept,2900,301,39,3240
Sao Paulo,570,4,5,4,acept,10870,2016,138,13024
Sao Paulo,54,2,1,1,acept,2200,0,28,2228
Campinas,150,4,2,0,acept,2500,184,38,2722
Sao Paulo,32,1,1,1,acept,3870,42,50,3962
Sao Paulo,127,3,2,2,acept,5000,250,76,5326
Porto Alegre,58,2,1,1,acept,800,24,12,836
Sao Paulo,230,3,2,2,acept,4590,309,69,4968
Sao Paulo,60,1,1,0,not acept,1600,192,25,1817
Porto Alegre,60,1,1,0,not acept,1170,0,18,1188
Sao Paulo,245,3,5,4,acept,11500,1584,146,13230
Sao Paulo,180,3,2,2,acept,7000,1200,89,8289
Porto Alegre,42,1,1,1,acept,900,19,14,933
Porto Alegre,41,1,1,0,acept,1090,84,16,1190
Belo Horizonte,800,4,4,3,acept,8000,834,132,8966
Belo Horizonte,700,7,6,5,acept,15000,1161,246,16407
Sao Paulo,140,3,3,2,acept,2300,0,35,2335
Porto Alegre,222,4,3,2,acept,4000,200,59,4259
Porto Alegre,122,3,3,2,acept,2500,149,37,2686
Rio de Janeiro,62,1,1,0,not acept,2700,156,35,2891
Sao Paulo,107,2,2,0,not acept,3150,0,40,3190
Belo Horizonte,59,2,2,0,not acept,1400,112,19,1531
Rio de Janeiro,40,1,1,0,acept,1360,1,18,1379
Campinas,72,3,1,1,acept,1075,49,14,1138
Belo Horizonte,400,4,6,4,acept,6000,668,80,6748
Sao Paulo,84,2,3,2,acept,6900,165,88,7153
Belo Horizonte,80,3,2,2,acept,1800,167,24,1991
Sao Paulo,90,2,2,0,acept,1750,0,27,1777
Belo Horizonte,413,4,4,0,acept,7900,692,106,8698
Sao Paulo,120,4,4,1,acept,4500,67,68,4635
Belo Horizonte,66,2,1,1,acept,1000,25,14,1039
Rio de Janeiro,140,3,2,1,not acept,3000,305,39,3344
Belo Horizonte,190,4,2,2,acept,3500,287,47,3834
Sao Paulo,325,5,5,4,acept,6000,420,91,6511
Rio de Janeiro,60,2,2,0,acept,2300,205,30,2535
Sao Paulo,310,4,4,3,acept,7000,675,106,7781
Sao Paulo,100,2,2,2,acept,6500,42,83,6625
Campinas,120,2,1,0,acept,1100,95,14,1209
Belo Horizonte,52,2,1,1,not acept,730,0,10,740
Sao Paulo,52,2,1,1,acept,1100,45,14,1159
Campinas,115,3,3,1,acept,1900,30,25,1955
Rio de Janeiro,47,1,1,1,acept,1000,0,13,1013
Sao Paulo,66,2,1,1,not acept,1780,0,23,1803
Sao Paulo,100,2,1,2,acept,1650,0,25,1675
Porto Alegre,55,2,1,1,acept,1319,75,20,1414
Sao Paulo,200,3,4,3,not acept,12000,1261,153,13414
Campinas,51,2,1,1,not acept,800,50,11,861
Sao Paulo,140,3,3,2,acept,2580,1000,33,3613
Belo Horizonte,200,4,4,3,acept,4200,580,56,4836
Porto Alegre,30,2,2,1,acept,1275,50,19,1344
Belo Horizonte,87,3,2,2,acept,3500,125,47,3672
Porto Alegre,100,3,2,1,acept,1800,211,27,2038
Sao Paulo,48,1,1,1,not acept,2000,0,8,2008
Rio de Janeiro,40,1,1,1,not acept,1160,91,15,1266
Porto Alegre,78,2,2,1,acept,2300,105,34,2439
Porto Alegre,41,1,2,1,acept,2800,67,41,2908
Sao Paulo,200,3,4,3,acept,5500,843,70,6413
Belo Horizonte,234,3,3,3,acept,8200,340,135,8675
Rio de Janeiro,136,3,1,0,acept,3000,0,39,3039
Sao Paulo,250,3,4,4,acept,3300,852,42,4194
Rio de Janeiro,125,3,2,1,not acept,3000,250,39,3289
Sao Paulo,86,2,1,0,acept,1387,130,21,1538
Porto Alegre,62,2,1,0,acept,1100,32,17,1149
Sao Paulo,120,3,2,2,acept,3110,111,47,3268
Campinas,61,1,1,0,acept,1900,43,25,1968
Porto Alegre,160,3,2,1,acept,2500,170,37,2707
Campinas,64,1,1,0,acept,1100,50,14,1164
Rio de Janeiro,70,3,2,1,acept,2100,94,28,2222
Campinas,258,2,2,1,acept,1400,67,22,1489
Belo Horizonte,163,4,3,2,acept,2300,136,31,2467
Sao Paulo,360,4,5,4,acept,1700,1417,22,3139
Rio de Janeiro,90,2,2,1,not acept,3973,422,52,4447
Sao Paulo,50,1,1,0,acept,1100,0,17,1117
Rio de Janeiro,264,4,4,1,not acept,7000,1067,91,8158
Rio de Janeiro,70,2,1,0,acept,2500,199,19,2718
Sao Paulo,126,2,2,1,not acept,3120,204,40,3364
Sao Paulo,35,1,1,1,not acept,2700,0,35,2735
Porto Alegre,98,2,2,1,acept,1300,54,19,1373
Rio de Janeiro,47,2,1,1,acept,1375,0,18,1393
Sao Paulo,70,3,2,1,acept,2000,109,26,2135
Porto Alegre,85,3,3,0,not acept,2500,72,45,2617
Rio de Janeiro,90,2,2,1,acept,3800,253,49,4102
Sao Paulo,250,3,4,3,acept,9000,834,115,9949
Rio de Janeiro,160,4,2,0,acept,6800,142,104,7046
Sao Paulo,25,1,1,0,not acept,1200,35,16,1251
Sao Paulo,97,2,3,2,acept,3300,243,42,3585
Sao Paulo,33,1,1,0,not acept,4000,0,51,4051
Rio de Janeiro,66,2,1,1,acept,1100,44,15,1159
Sao Paulo,78,3,2,2,acept,1540,230,20,1790
Sao Paulo,248,3,4,3,acept,6000,742,77,6819
Sao Paulo,163,3,2,1,acept,4000,84,51,4135
Sao Paulo,332,5,4,3,acept,15000,1167,191,16358
Sao Paulo,30,1,1,1,acept,1850,70,24,1944
Rio de Janeiro,172,3,3,3,acept,5000,800,65,5865
Belo Horizonte,100,3,2,0,acept,1550,125,26,1701
Sao Paulo,260,4,4,2,acept,5200,184,79,5463
Sao Paulo,432,5,7,6,acept,15000,3007,191,18198
Sao Paulo,46,2,1,1,not acept,1180,25,15,1220
Sao Paulo,999,5,7,4,not acept,15000,459,226,15685
Belo Horizonte,274,6,6,2,acept,9000,671,148,9819
Rio de Janeiro,76,2,1,0,acept,1000,50,13,1063
Belo Horizonte,210,4,4,2,not acept,4200,283,56,4539
Sao Paulo,400,4,5,4,acept,11000,2028,166,13194
Sao Paulo,110,3,2,1,acept,1200,350,16,1566
Sao Paulo,20,1,1,0,acept,1800,130,23,1953
Sao Paulo,160,3,2,2,not acept,3500,250,53,3803
Rio de Janeiro,95,3,2,2,acept,5800,430,75,6305
Sao Paulo,38,1,1,0,not acept,2001,0,26,2027
Sao Paulo,220,4,3,3,acept,5500,1092,70,6662
Belo Horizonte,396,4,5,6,acept,10000,250,164,10414
Sao Paulo,360,4,7,5,acept,3990,2505,51,6546
Rio de Janeiro,25,1,1,0,acept,1910,0,25,1935
Sao Paulo,120,3,2,8,acept,3000,386,46,3432
Sao Paulo,556,6,7,4,acept,7500,1084,113,8697
Belo Horizonte,100,3,1,1,acept,1970,92,33,2095
Sao Paulo,40,1,1,0,not acept,780,17,12,809
Campinas,55,2,1,1,acept,700,0,9,709
Rio de Janeiro,60,2,1,0,not acept,2000,57,26,2083
Sao Paulo,70,3,1,2,not acept,3200,140,41,3381
Sao Paulo,52,2,1,1,acept,1200,65,16,1281
Rio de Janeiro,110,3,2,1,not acept,2500,140,33,2673
Sao Paulo,53,2,1,1,acept,1800,22,23,1845
Sao Paulo,188,1,3,2,not acept,8000,550,102,8652
Porto Alegre,121,3,2,1,acept,1900,200,28,2128
Sao Paulo,80,1,1,1,not acept,1300,84,20,1404
Belo Horizonte,160,4,2,2,acept,2700,305,36,3041
Sao Paulo,285,4,5,4,acept,20000,1834,254,22088
Sao Paulo,70,2,1,0,acept,1350,0,21,1371
Campinas,53,2,2,1,acept,1900,54,25,1979
Rio de Janeiro,320,3,6,3,acept,6490,900,84,7474
Rio de Janeiro,96,2,2,2,acept,7500,434,97,8031
Sao Paulo,35,1,1,1,acept,2100,0,27,2127
Campinas,375,4,5,0,acept,10000,825,151,10976
Sao Paulo,60,2,1,0,acept,1700,245,26,1971
Belo Horizonte,100,7,2,1,acept,2800,28,46,2874
Rio de Janeiro,82,2,1,0,acept,4950,59,76,5085
Sao Paulo,57,1,1,0,acept,6000,17,77,6094
Sao Paulo,485,5,6,6,acept,13000,2495,165,15660
Sao Paulo,61,1,2,1,not acept,1930,87,25,2042
Rio de Janeiro,28,1,1,0,acept,1009,0,7,1016
Sao Paulo,130,3,2,1,not acept,7500,417,96,8013
Porto Alegre,119,3,1,0,acept,2100,84,31,2215
Sao Paulo,123,3,1,1,not acept,3800,348,49,4197
Campinas,96,2,1,1,acept,1800,52,23,1875
Rio de Janeiro,120,3,2,2,acept,5500,250,71,5821
Rio de Janeiro,89,3,1,1,acept,2000,90,26,2116
Sao Paulo,190,3,3,2,not acept,9000,888,115,10003
Belo Horizonte,402,4,4,4,acept,7500,483,123,8106
Rio de Janeiro,40,1,1,0,acept,1180,0,16,1196
Sao Paulo,210,4,3,3,acept,4000,750,51,4801
Sao Paulo,77,2,2,1,acept,3170,34,41,3245
Belo Horizonte,65,3,1,1,not acept,900,69,12,981
Sao Paulo,160,3,4,3,acept,2770,475,42,3287
Rio de Janeiro,80,2,3,1,acept,3100,240,40,3380
Porto Alegre,110,3,2,0,not acept,2070,100,31,2201
Porto Alegre,132,3,2,2,acept,3350,167,49,3566
Belo Horizonte,90,3,2,2,acept,3500,325,47,3872
Porto Alegre,50,2,1,1,acept,1540,0,23,1563
Sao Paulo,55,3,1,1,acept,1800,121,23,1944
Sao Paulo,40,1,1,0,acept,3480,142,45,3667
Rio de Janeiro,38,2,2,1,acept,3200,200,42,3442
Sao Paulo,50,2,1,1,acept,1100,50,14,1164
Sao Paulo,136,3,3,1,acept,7500,290,96,7886
Rio de Janeiro,140,3,2,2,acept,2700,169,35,2904
Rio de Janeiro,150,4,2,2,acept,9000,834,116,9950
Belo Horizonte,65,2,2,1,acept,1400,81,19,1500
Sao Paulo,41,3,2,1,not acept,6500,0,83,6583
Sao Paulo,180,3,3,1,acept,6000,294,77,6371
Porto Alegre,425,4,4,0,acept,15000,750,267,16017
Porto Alegre,70,2,1,1,acept,1800,63,27,1890
Sao Paulo,460,6,6,4,acept,6500,109,98,6707
Rio de Janeiro,70,2,2,1,not acept,6000,835,78,6913
Sao Paulo,25,1,1,0,acept,2200,45,28,2273
Sao Paulo,274,4,5,6,acept,11000,767,166,11933
Sao Paulo,42,1,1,2,acept,3380,0,43,3423
Porto Alegre,64,2,1,1,acept,980,34,15,1029
Rio de Janeiro,31,1,1,0,acept,1350,67,18,1435
Sao Paulo,74,2,1,0,acept,2850,0,37,2887
Sao Paulo,110,2,3,3,not acept,1890,0,24,1914
Sao Paulo,20,1,1,0,acept,1800,130,23,1953
Belo Horizonte,91,2,3,1,acept,2350,221,32,2603
Porto Alegre,85,2,3,1,acept,3000,125,44,3169
Sao Paulo,42,1,1,1,not acept,3000,192,39,3231
Porto Alegre,359,3,4,2,acept,7000,292,103,7395
Porto Alegre,89,2,1,0,not acept,1190,0,18,1208
Sao Paulo,50,1,1,0,not acept,750,0,12,762
Sao Paulo,43,1,1,0,acept,1600,17,21,1638
Sao Paulo,40,1,1,1,not acept,5000,184,64,5248
Campinas,42,1,1,1,acept,1750,75,23,1848
Rio de Janeiro,143,3,2,1,acept,2058,84,27,2169
Porto Alegre,140,3,1,1,acept,4445,166,65,4676
Sao Paulo,60,1,1,1,acept,750,9,10,769
Rio de Janeiro,121,1,1,0,acept,6800,300,88,7188
Porto Alegre,148,3,2,2,acept,3990,167,59,4216
Rio de Janeiro,130,4,3,0,acept,9900,141,128,10169
Rio de Janeiro,35,1,1,0,acept,4500,9900,58,14458
Rio de Janeiro,85,3,2,1,acept,4170,225,54,4449
Sao Paulo,40,1,1,0,not acept,900,25,14,939
Rio de Janeiro,53,2,1,1,acept,1239,0,16,1255
Sao Paulo,80,3,2,2,acept,2650,92,34,2776
Sao Paulo,77,3,3,2,acept,2400,70,37,2507
Sao Paulo,103,3,2,2,acept,7550,209,96,7855
Porto Alegre,78,2,2,0,acept,1500,167,22,1689
Sao Paulo,158,3,4,2,acept,2750,142,35,2927
Sao Paulo,300,4,4,3,acept,13100,1500,166,14766
Rio de Janeiro,65,2,1,1,acept,1000,125,13,1138
Sao Paulo,58,2,2,1,not acept,2055,0,27,2082
Sao Paulo,250,3,4,0,acept,5000,1334,64,6398
Sao Paulo,440,4,4,4,acept,10200,2849,130,13179
Porto Alegre,39,1,1,1,acept,2200,50,33,2283
Porto Alegre,45,2,2,0,not acept,1300,0,24,1324
Belo Horizonte,200,4,3,3,acept,7900,700,106,8706
Porto Alegre,40,1,1,0,acept,1250,6,19,1275
Belo Horizonte,75,2,1,1,acept,849,71,12,932
Campinas,85,2,2,1,acept,1310,79,17,1406
Rio de Janeiro,57,2,1,1,acept,1000,43,13,1056
Sao Paulo,60,3,1,0,not acept,1950,109,25,2084
Campinas,46,2,1,1,acept,850,18,11,879
Belo Horizonte,57,2,2,1,acept,1460,125,20,1605
Sao Paulo,102,3,2,2,acept,4200,250,54,4504
Sao Paulo,61,2,2,1,acept,2300,21,30,2351
Rio de Janeiro,29,1,1,0,acept,1770,83,23,1876
Sao Paulo,280,3,3,2,acept,8000,600,121,8721
Sao Paulo,210,3,3,4,acept,6500,1400,83,7983
Sao Paulo,130,3,3,3,acept,4000,146,61,4207
Porto Alegre,45,1,1,0,acept,900,658,14,1572
Belo Horizonte,45,1,1,1,acept,2900,9,39,2948
Rio de Janeiro,40,1,1,0,acept,2000,50,26,2076
Sao Paulo,175,1,1,2,acept,1600,167,25,1792
Sao Paulo,750,4,5,8,acept,15000,4338,226,19564
Sao Paulo,60,2,3,2,not acept,1200,182,16,1398
Sao Paulo,86,2,1,1,not acept,3800,155,49,4004
Porto Alegre,75,2,2,2,acept,2200,95,33,2328
Porto Alegre,281,4,3,4,acept,4950,442,88,5480
Porto Alegre,70,2,2,1,acept,2200,92,33,2325
Rio de Janeiro,280,3,3,2,acept,8000,1680,104,9784
Sao Paulo,30,1,1,0,acept,1850,0,24,1874
Campinas,100,2,2,1,acept,2000,0,26,2026
Sao Paulo,271,3,2,2,acept,4800,646,73,5519
Sao Paulo,123,3,3,2,not acept,3400,334,44,3778
Sao Paulo,59,2,2,0,acept,3900,143,50,4093
Sao Paulo,130,2,3,3,acept,1830,0,28,1858
Porto Alegre,58,1,1,1,acept,1200,27,18,1245
Sao Paulo,42,1,1,1,acept,2325,128,30,2483
Sao Paulo,168,3,2,4,not acept,3500,317,53,3870
Sao Paulo,430,4,7,6,acept,7990,300,121,8411
Rio de Janeiro,90,3,2,1,acept,980,120,13,1113
Rio de Janeiro,36,1,1,0,acept,2000,0,26,2026
Rio de Janeiro,45,1,1,1,acept,2700,196,35,2931
Belo Horizonte,73,3,1,1,acept,1400,121,19,1540
Sao Paulo,38,1,1,0,not acept,950,0,13,963
Sao Paulo,95,3,2,1,acept,2300,0,30,2330
Campinas,60,1,1,1,acept,1700,37,22,1759
Belo Horizonte,60,2,1,1,not acept,2000,66,27,2093
Sao Paulo,44,1,1,1,not acept,2000,29,26,2055
Porto Alegre,39,1,1,1,not acept,900,27,14,941
Campinas,30,1,1,0,not acept,1100,9,14,1123
Sao Paulo,250,3,3,2,not acept,3700,459,56,4215
Sao Paulo,170,3,3,3,acept,3500,209,53,3762
Sao Paulo,65,2,1,0,acept,1800,167,28,1995
Sao Paulo,320,3,3,4,acept,4320,142,65,4527
Sao Paulo,60,2,1,3,acept,2200,188,34,2422
Porto Alegre,100,3,1,0,acept,1870,59,28,1957
Sao Paulo,100,2,2,2,acept,2800,450,36,3286
Sao Paulo,45,2,1,0,acept,900,42,12,954
Sao Paulo,270,5,7,2,acept,3978,89,60,4127
Rio de Janeiro,90,3,2,1,not acept,3500,350,46,3896
Campinas,51,2,1,2,not acept,1850,56,24,1930
Sao Paulo,72,2,2,1,acept,1760,30,23,1813
Rio de Janeiro,45,1,1,1,not acept,2000,50,26,2076
Porto Alegre,60,2,1,0,acept,1090,25,16,1131
Sao Paulo,213,3,3,2,not acept,6500,475,83,7058
Sao Paulo,33,1,1,0,not acept,1305,0,17,1322
Campinas,74,3,1,1,acept,814,49,11,874
Sao Paulo,120,3,1,1,acept,2625,0,26,2651
Rio de Janeiro,45,1,1,0,acept,1900,13,25,1938
Sao Paulo,59,2,2,1,acept,3478,75,14,3567
Rio de Janeiro,35,1,1,0,not acept,4500,67,58,4625
Sao Paulo,253,4,5,3,acept,4100,0,52,4152
Campinas,78,3,2,1,acept,1600,67,21,1688
Belo Horizonte,200,4,3,3,not acept,5000,547,67,5614
Sao Paulo,128,3,3,2,acept,3800,605,49,4454
Belo Horizonte,200,5,2,5,acept,4000,148,54,4202
Sao Paulo,60,2,2,1,acept,1250,38,16,1304
Sao Paulo,244,3,4,2,acept,12000,648,153,12801
Sao Paulo,120,2,1,1,not acept,3000,280,46,3326
Campinas,145,4,3,2,acept,5700,292,73,6065
Sao Paulo,120,3,2,1,acept,4675,200,60,4935
Campinas,34,1,1,0,acept,650,70,9,729
Sao Paulo,90,2,1,2,acept,2000,0,26,2026
Campinas,76,2,1,0,acept,700,100,9,809
Sao Paulo,69,3,2,1,acept,2000,6,26,2032
Sao Paulo,150,3,2,0,acept,2500,150,38,2688
Sao Paulo,101,2,2,1,acept,1700,0,22,1722
Sao Paulo,225,3,3,2,acept,10800,670,137,11607
Sao Paulo,220,4,4,4,acept,4500,540,58,5098
Porto Alegre,79,2,1,0,acept,1880,67,28,1975
Sao Paulo,25,1,1,0,acept,1200,25,19,1244
Sao Paulo,277,3,5,4,acept,9000,771,136,9907
Sao Paulo,282,4,4,3,acept,10000,1334,127,11461
Sao Paulo,200,4,5,3,not acept,5500,997,70,6567
Porto Alegre,45,1,1,2,acept,2300,9,34,2343
Sao Paulo,280,4,4,3,acept,6553,0,84,6637
Sao Paulo,155,4,3,2,acept,3500,459,45,4004
Sao Paulo,44,1,1,1,acept,1900,19,25,1944
Belo Horizonte,312,4,5,4,acept,8000,890,107,8997
Rio de Janeiro,90,2,1,0,acept,1200,142,16,1358
Sao Paulo,64,2,1,1,acept,1850,75,24,1949
Sao Paulo,150,2,2,3,not acept,8000,570,102,8672
Sao Paulo,65,2,1,0,acept,1300,70,17,1387
Porto Alegre,47,1,1,1,not acept,2200,0,33,2233
Rio de Janeiro,40,1,1,0,acept,1980,84,26,2090
Sao Paulo,50,1,1,0,acept,1800,0,23,1823
Belo Horizonte,120,3,3,2,acept,2320,125,39,2484
Rio de Janeiro,95,3,1,0,acept,3000,140,39,3179
Rio de Janeiro,25,1,1,2,not acept,1650,42,22,1714
Sao Paulo,202,4,3,4,acept,12000,1896,153,14049
Rio de Janeiro,30,1,1,0,acept,1000,17,13,1030
Porto Alegre,30,1,1,0,acept,850,18,13,881
Belo Horizonte,1000,3,4,2,acept,5000,365,82,5447
Porto Alegre,80,3,1,1,acept,1700,125,25,1850
Belo Horizonte,120,4,3,2,acept,3250,0,44,3294
Sao Paulo,249,3,3,3,acept,9000,834,136,9970
Sao Paulo,90,3,3,2,acept,2600,360,33,2993
Rio de Janeiro,91,2,2,1,acept,3450,201,45,3696
Sao Paulo,36,1,1,0,acept,1162,19,15,1196
Sao Paulo,51,2,1,1,acept,2900,114,37,3051
Sao Paulo,287,4,4,4,not acept,11300,2590,144,14034
Rio de Janeiro,65,2,2,1,acept,6700,262,87,7049
Sao Paulo,84,2,2,2,not acept,9600,217,122,9939
Sao Paulo,43,1,1,1,not acept,3600,133,46,3779
Sao Paulo,58,2,1,1,acept,1540,0,20,1560
Sao Paulo,208,4,4,3,acept,8000,1672,102,9774
Sao Paulo,462,7,2,3,not acept,8600,834,130,9564
Sao Paulo,167,3,2,1,acept,9500,500,121,10121
Sao Paulo,62,2,1,1,not acept,1236,34,16,1286
Porto Alegre,75,2,2,0,acept,2500,140,37,2677
Campinas,244,5,7,4,acept,8000,500,102,8602
Sao Paulo,309,4,7,8,acept,8000,1250,121,9371
Porto Alegre,40,1,1,0,acept,950,100,14,1064
Porto Alegre,90,2,1,0,acept,950,26,14,990
Porto Alegre,47,1,1,0,not acept,1100,0,17,1117
Porto Alegre,143,3,2,3,acept,6000,698,88,6786
Sao Paulo,230,3,4,3,not acept,4210,1167,54,5431
Sao Paulo,580,6,6,6,acept,6960,2084,105,9149
Sao Paulo,238,4,4,3,acept,15000,542,191,15733
Sao Paulo,113,3,4,3,acept,3400,178,44,3622
Sao Paulo,115,2,2,2,not acept,3800,259,49,4108
Sao Paulo,80,1,2,1,acept,4000,109,51,4160
Rio de Janeiro,300,4,4,3,acept,4500,803,58,5361
Campinas,70,1,1,2,acept,1450,5,22,1477
Sao Paulo,52,2,1,0,acept,990,0,13,1003
Sao Paulo,55,2,1,1,acept,1530,100,20,1650
Rio de Janeiro,58,2,1,1,acept,750,44,10,804
Campinas,50,2,1,1,acept,1150,0,15,1165
Campinas,40,1,1,0,acept,500,17,7,524
Sao Paulo,164,3,2,1,acept,3700,198,47,3945
Porto Alegre,76,2,2,0,acept,2100,49,38,2187
Sao Paulo,80,2,1,1,acept,2800,209,36,3045
Belo Horizonte,300,5,4,3,acept,15000,417,246,15663
Porto Alegre,75,2,2,2,acept,1600,122,24,1746
Sao Paulo,280,3,4,2,acept,8000,667,121,8788
Porto Alegre,50,1,1,1,not acept,1200,50,18,1268
Sao Paulo,74,1,2,2,acept,5500,294,70,5864
Sao Paulo,73,2,1,1,acept,2080,0,27,2107
Campinas,280,4,3,4,acept,3100,341,47,3488
Rio de Janeiro,403,3,4,2,acept,15000,667,194,15861
Campinas,424,4,5,4,acept,3315,358,50,3723
Sao Paulo,190,4,5,3,acept,4000,417,51,4468
Sao Paulo,454,4,3,4,acept,10900,917,164,11981
Sao Paulo,138,3,2,1,not acept,7600,238,97,7935
Sao Paulo,600,5,5,6,acept,15000,2100,191,17291
Campinas,58,2,1,1,acept,3500,64,45,3609
Sao Paulo,38,1,1,0,acept,2500,0,32,2532
Sao Paulo,113,2,2,1,acept,3000,50,39,3089
Sao Paulo,70,2,1,0,not acept,1700,25,26,1751
Rio de Janeiro,90,2,1,0,acept,4000,1,52,4053
Sao Paulo,183,4,4,3,acept,5000,834,64,5898
Rio de Janeiro,20,1,1,0,acept,1370,25,18,1413
Belo Horizonte,66,2,1,1,acept,500,23,7,530
Rio de Janeiro,92,2,2,0,acept,2700,250,35,2985
Porto Alegre,70,2,1,0,not acept,1800,0,27,1827
Sao Paulo,93,3,2,1,acept,3400,227,44,3671
Sao Paulo,220,4,5,4,not acept,3230,1577,41,4848
Sao Paulo,20,1,1,0,not acept,600,40,8,648
Sao Paulo,92,3,2,2,not acept,2200,198,34,2432
Belo Horizonte,50,2,1,0,not acept,1200,250,16,1466
Sao Paulo,300,3,5,2,not acept,13900,809,177,14886
Porto Alegre,90,3,1,1,acept,1750,90,26,1866
Campinas,36,1,1,0,not acept,500,10,7,517
Rio de Janeiro,70,2,2,0,acept,2250,135,29,2414
Sao Paulo,200,3,3,2,acept,3500,292,53,3845
Rio de Janeiro,160,3,2,1,acept,6800,513,88,7401
Sao Paulo,135,3,2,3,acept,2800,635,36,3471
Sao Paulo,70,1,1,0,acept,1200,34,19,1253
Belo Horizonte,95,2,1,1,not acept,2000,94,27,2121
Sao Paulo,60,2,2,2,acept,1900,90,25,2015
Sao Paulo,36,1,1,0,acept,860,50,11,921
Sao Paulo,136,3,3,3,acept,6000,600,77,6677
Sao Paulo,250,3,2,2,acept,3500,250,53,3803
Sao Paulo,330,3,5,3,acept,15000,2500,191,17691
Belo Horizonte,65,3,2,1,not acept,950,82,13,1045
Campinas,380,3,4,4,acept,8000,534,121,8655
Sao Paulo,350,5,5,4,acept,3000,467,46,3513
Campinas,70,2,1,0,acept,700,39,9,748
Rio de Janeiro,65,2,2,0,acept,1500,70,20,1590
Sao Paulo,45,1,1,1,not acept,5520,0,70,5590
Rio de Janeiro,95,2,2,0,acept,3430,263,45,3738
Sao Paulo,120,2,1,1,acept,1600,167,25,1792
Sao Paulo,248,3,4,3,acept,5300,1521,68,6889
Sao Paulo,100,2,1,2,not acept,3300,317,50,3667
Sao Paulo,394,4,6,4,acept,4000,2500,51,6551
Campinas,209,3,3,2,not acept,2550,237,39,2826
Rio de Janeiro,16,1,1,0,acept,555,30,8,593
Sao Paulo,49,2,1,1,acept,1700,135,22,1857
Rio de Janeiro,70,2,2,1,not acept,4100,13,53,4166
Rio de Janeiro,150,3,2,3,acept,2430,38,32,2500
Porto Alegre,58,2,1,1,acept,1320,67,20,1407
Sao Paulo,200,3,4,1,not acept,6000,375,77,6452
Belo Horizonte,400,3,3,0,acept,3500,142,58,3700
Sao Paulo,196,3,4,2,not acept,3300,559,42,3901
Porto Alegre,40,1,1,0,not acept,2000,0,30,2030
Belo Horizonte,158,3,3,2,acept,3700,360,50,4110
Sao Paulo,130,2,1,1,acept,4000,0,61,4061
Campinas,48,1,2,0,acept,987,46,13,1046
Sao Paulo,72,2,1,1,acept,1440,51,19,1510
Sao Paulo,65,2,1,0,acept,1680,33,22,1735
Porto Alegre,60,2,1,1,acept,1900,50,28,1978
Sao Paulo,48,1,1,1,acept,1525,0,6,1531
Rio de Janeiro,47,1,1,0,not acept,1400,22,19,1441
Porto Alegre,84,2,1,0,acept,900,73,14,987
Sao Paulo,186,4,2,2,acept,2500,0,32,2532
Belo Horizonte,85,3,2,2,not acept,1500,114,20,1634
Sao Paulo,160,4,5,3,acept,3800,834,49,4683
Rio de Janeiro,74,2,1,1,acept,900,65,12,977
Sao Paulo,18,1,1,0,acept,1720,0,22,1742
Porto Alegre,130,2,1,2,acept,2000,109,36,2145
Belo Horizonte,95,3,2,1,acept,2300,182,31,2513
Sao Paulo,105,3,2,3,acept,1900,552,25,2477
Belo Horizonte,85,2,2,1,acept,1100,119,15,1234
Belo Horizonte,50,1,1,2,acept,1280,83,21,1384
Rio de Janeiro,103,3,2,1,acept,4500,290,58,4848
Sao Paulo,54,2,1,1,acept,780,0,10,790
Campinas,75,2,1,2,acept,1400,25,18,1443
Sao Paulo,25,1,1,0,not acept,1200,35,16,1251
Belo Horizonte,63,3,2,2,not acept,1300,90,18,1408
Belo Horizonte,150,5,5,5,acept,14000,835,230,15065
Sao Paulo,47,2,1,1,acept,1570,0,20,1590
Rio de Janeiro,140,3,2,3,acept,4235,145,55,4435
Rio de Janeiro,40,1,1,0,acept,1110,0,15,1125
Belo Horizonte,115,3,2,1,not acept,2200,110,30,2340
Sao Paulo,160,4,3,2,acept,9530,286,121,9937
Rio de Janeiro,80,1,1,0,not acept,1400,38,22,1460
Rio de Janeiro,75,2,1,1,acept,1100,50,15,1165
Porto Alegre,80,2,1,0,acept,950,65,14,1029
Sao Paulo,80,2,2,1,acept,2600,417,40,3057
Sao Paulo,199,3,4,5,acept,4000,1500,51,5551
Sao Paulo,400,4,4,3,acept,9000,542,136,9678
Sao Paulo,70,1,1,0,not acept,1086,163,17,1266
Sao Paulo,300,4,5,4,acept,5000,538,76,5614
Belo Horizonte,70,2,1,1,acept,1100,103,15,1218
Sao Paulo,250,3,2,1,acept,8500,5000,108,13608
Rio de Janeiro,27,1,1,0,acept,1700,67,22,1789
Sao Paulo,54,2,1,1,not acept,2010,71,26,2107
Sao Paulo,225,4,5,4,acept,9000,1192,115,10307
Sao Paulo,125,3,2,1,acept,4655,200,59,4914
Sao Paulo,55,2,1,0,acept,2000,75,31,2106
Sao Paulo,186,3,3,2,not acept,5435,405,69,5909
Rio de Janeiro,154,3,3,1,acept,5000,367,65,5432
Sao Paulo,200,3,4,2,not acept,9800,417,148,10365
Sao Paulo,246,3,4,3,acept,4500,794,58,5352
Porto Alegre,78,2,1,0,acept,1380,32,21,1433
Sao Paulo,70,2,1,1,acept,2100,0,32,2132
Sao Paulo,188,3,1,3,acept,9500,472,143,10115
Belo Horizonte,165,3,2,4,acept,2870,142,39,3051
Campinas,63,2,1,0,acept,950,0,13,963
Belo Horizonte,200,4,2,2,acept,4000,421,54,4475
Sao Paulo,298,4,5,4,not acept,6000,1250,77,7327
Sao Paulo,154,3,1,3,acept,6700,400,85,7185
Campinas,110,3,2,2,not acept,2100,100,27,2227
Campinas,130,2,2,5,acept,1800,321,28,2149
Sao Paulo,32,1,1,1,not acept,3500,234,45,3779
Rio de Janeiro,170,4,3,2,acept,2430,500,32,2962
Sao Paulo,69,2,1,0,acept,1600,0,21,1621
Rio de Janeiro,118,2,2,1,acept,3950,271,51,4272
Rio de Janeiro,90,3,1,0,acept,2800,109,37,2946
Campinas,65,1,1,1,acept,1200,83,16,1299
Sao Paulo,260,4,3,4,acept,4000,1200,51,5251
Sao Paulo,182,3,5,3,acept,4900,875,63,5838
Sao Paulo,41,1,1,1,not acept,3500,100,45,3645
Sao Paulo,45,1,1,0,acept,1400,0,22,1422
Sao Paulo,40,1,1,0,not acept,780,17,12,809
Sao Paulo,100,1,3,2,not acept,2500,125,32,2657
Sao Paulo,66,2,1,0,acept,1650,0,21,1671
Belo Horizonte,71,3,2,2,acept,970,149,13,1132
Campinas,94,2,1,1,acept,1200,88,16,1304
Rio de Janeiro,80,2,2,1,acept,1380,215,18,1613
Sao Paulo,41,1,1,1,not acept,3220,0,13,3233
Sao Paulo,140,3,2,1,acept,3825,0,58,3883
Porto Alegre,47,1,1,1,not acept,2200,0,33,2233
Rio de Janeiro,70,3,1,1,acept,1200,0,16,1216
Campinas,58,1,1,1,acept,720,40,10,770
Sao Paulo,200,3,4,4,acept,5600,860,71,6531
Rio de Janeiro,40,1,1,0,acept,725,0,10,735
Sao Paulo,240,3,4,4,not acept,4000,370,61,4431
Sao Paulo,96,3,2,1,acept,3050,231,39,3320
Sao Paulo,220,4,5,2,acept,6500,1176,98,7774
Sao Paulo,132,3,2,2,acept,4000,400,51,4451
Belo Horizonte,106,3,2,2,not acept,2200,239,30,2469
Sao Paulo,150,3,3,2,acept,2000,584,26,2610
Sao Paulo,68,3,1,1,not acept,1400,0,18,1418
Porto Alegre,180,4,5,3,acept,10500,410,154,11064
Porto Alegre,44,1,1,1,acept,1170,31,18,1219
Rio de Janeiro,75,2,1,0,acept,1900,267,25,2192
Sao Paulo,58,2,2,1,acept,4700,5,60,4765
Sao Paulo,72,2,1,0,acept,2200,17,28,2245
Sao Paulo,190,4,4,2,acept,3500,315,53,3868
Rio de Janeiro,150,3,2,1,acept,1300,140,17,1457
Campinas,550,3,7,8,acept,7700,430,116,8246
Sao Paulo,220,2,2,3,acept,10500,750,158,11408
Sao Paulo,200,3,2,3,acept,6000,209,91,6300
Belo Horizonte,300,5,3,4,acept,6800,167,112,7079
Sao Paulo,70,2,2,0,not acept,2280,92,29,2401
Campinas,43,2,1,1,acept,1000,7,13,1020
Porto Alegre,45,1,1,1,acept,740,7,11,758
Porto Alegre,55,2,1,0,acept,650,42,10,702
Sao Paulo,700,5,8,3,acept,12000,1000,181,13181
Belo Horizonte,300,3,5,0,acept,5500,310,91,5901
Porto Alegre,220,4,5,2,acept,7000,225,125,7350
Sao Paulo,300,4,5,6,acept,15000,1805,226,17031
Porto Alegre,52,1,1,0,acept,748,1,11,760
Rio de Janeiro,106,2,2,1,acept,4000,323,52,4375
Porto Alegre,84,2,2,2,acept,3200,189,47,3436
Sao Paulo,50,2,1,0,not acept,1200,0,19,1219
Sao Paulo,240,3,3,2,acept,4000,292,61,4353
Sao Paulo,240,3,3,4,acept,8000,1000,121,9121
Porto Alegre,260,2,2,1,not acept,1640,0,24,1664
Sao Paulo,73,2,2,1,acept,1250,150,16,1416
Sao Paulo,334,4,6,5,acept,3800,2435,49,6284
Sao Paulo,67,2,1,1,acept,1200,167,16,1383
Sao Paulo,71,2,1,0,not acept,1800,0,23,1823
Sao Paulo,280,3,4,3,not acept,7600,1250,97,8947
Belo Horizonte,450,5,5,3,acept,6500,542,107,7149
Porto Alegre,82,3,2,1,acept,2500,59,37,2596
Sao Paulo,380,4,5,4,acept,8000,2667,102,10769
Porto Alegre,105,3,2,2,acept,2390,134,35,2559
Sao Paulo,55,1,1,1,acept,1800,0,7,1807
Sao Paulo,45,1,1,0,not acept,1500,0,20,1520
Sao Paulo,70,2,2,1,acept,3100,117,40,3257
Sao Paulo,160,3,3,0,not acept,5000,500,76,5576
Sao Paulo,48,2,1,1,acept,1710,0,22,1732
Sao Paulo,200,3,4,2,acept,9180,0,117,9297
Sao Paulo,46,2,1,0,acept,1200,0,16,1216
Rio de Janeiro,30,1,1,0,not acept,680,0,9,689
Rio de Janeiro,140,3,2,1,acept,3600,375,47,4022
Sao Paulo,101,3,3,2,acept,4600,330,59,4989
Sao Paulo,340,2,4,3,acept,15000,917,191,16108
Sao Paulo,400,4,5,4,acept,7000,1500,89,8589
Campinas,55,2,1,1,acept,749,44,10,803
Rio de Janeiro,45,2,1,1,acept,1450,18,19,1487
Sao Paulo,62,2,2,0,acept,1250,0,19,1269
Rio de Janeiro,75,2,1,0,acept,3190,196,42,3428
Sao Paulo,86,3,1,1,acept,3150,0,40,3190
Porto Alegre,182,3,3,2,acept,3200,112,57,3369
Porto Alegre,30,1,1,1,acept,762,15,14,791
Rio de Janeiro,153,4,3,1,acept,2710,121,42,2873
Sao Paulo,70,2,1,1,acept,1100,77,17,1194
Rio de Janeiro,82,2,1,1,acept,1840,83,24,1947
Sao Paulo,160,3,4,4,not acept,7000,534,106,7640
Sao Paulo,270,5,4,4,not acept,7000,1684,89,8773
Sao Paulo,370,7,6,8,acept,10000,1875,151,12026
Sao Paulo,470,4,6,2,acept,7200,1000,109,8309
Sao Paulo,200,1,1,3,acept,1600,264,25,1889
Sao Paulo,62,2,2,0,not acept,1400,92,18,1510
Sao Paulo,64,2,2,1,acept,2500,5,32,2537
Sao Paulo,58,2,1,1,acept,1100,0,14,1114
Porto Alegre,75,2,2,0,not acept,1350,50,20,1420
Sao Paulo,200,2,2,2,acept,11000,560,140,11700
Sao Paulo,36,1,1,1,acept,1600,60,21,1681
Porto Alegre,120,2,2,1,acept,1700,134,25,1859
Porto Alegre,62,2,2,2,acept,1600,9,24,1633
Sao Paulo,490,3,3,3,acept,4450,1200,67,5717
Belo Horizonte,67,2,2,2,not acept,3170,34,43,3247
Sao Paulo,161,3,3,3,acept,2500,741,32,3273
Sao Paulo,176,4,2,3,acept,5000,0,76,5076
Sao Paulo,178,4,4,4,acept,4500,688,58,5246
Porto Alegre,88,3,2,0,acept,1658,31,25,1714
Porto Alegre,470,3,3,4,acept,3700,346,66,4112
Sao Paulo,257,4,3,2,acept,7000,1200,106,8306
Sao Paulo,70,4,3,0,acept,3500,270,53,3823
Belo Horizonte,50,2,1,1,acept,700,62,10,772
Belo Horizonte,89,3,2,1,acept,1300,138,18,1456
Sao Paulo,73,2,1,1,acept,1300,21,17,1338
Sao Paulo,95,3,2,2,acept,4500,325,58,4883
Rio de Janeiro,54,2,1,1,acept,1600,0,21,1621
Belo Horizonte,150,4,1,3,acept,4350,542,58,4950
Rio de Janeiro,139,2,3,1,acept,5966,387,77,6430
Porto Alegre,45,1,1,0,acept,1700,55,25,1780
Sao Paulo,255,4,4,4,acept,3400,375,52,3827
Sao Paulo,100,1,1,0,acept,2150,267,33,2450
Sao Paulo,120,3,3,1,acept,2870,0,37,2907
Campinas,200,4,5,2,not acept,8000,84,121,8205
Sao Paulo,72,2,1,1,acept,1280,6,17,1303
Porto Alegre,50,1,1,0,acept,1100,13,20,1133
Sao Paulo,158,3,4,3,not acept,12000,738,153,12891
Sao Paulo,22,1,1,0,acept,2100,40,27,2167
Sao Paulo,105,3,2,1,acept,2380,374,31,2785
Sao Paulo,50,2,1,1,acept,1500,3,20,1523
Belo Horizonte,65,2,2,0,acept,1200,19,16,1235
Sao Paulo,108,3,2,2,acept,2000,195,26,2221
Campinas,50,1,1,0,acept,1080,15,14,1109
Sao Paulo,198,3,3,6,acept,4200,250,64,4514
Campinas,74,3,2,1,acept,1800,120,23,1943
Rio de Janeiro,71,2,2,1,not acept,5500,246,71,5817
Porto Alegre,52,2,1,1,acept,1100,42,17,1159
Belo Horizonte,355,3,4,8,acept,6000,1106,80,7186
Porto Alegre,162,3,1,0,acept,1300,67,19,1386
Sao Paulo,90,1,1,0,not acept,2000,0,26,2026
Porto Alegre,62,2,1,1,not acept,1377,54,21,1452
Sao Paulo,130,3,2,2,acept,3000,0,46,3046
Sao Paulo,78,1,1,0,acept,2522,25,32,2579
Sao Paulo,276,4,5,4,acept,4900,183,74,5157
Sao Paulo,50,2,1,1,acept,1500,88,20,1608
Porto Alegre,35,1,1,0,acept,1500,50,22,1572
Belo Horizonte,161,3,1,2,acept,3500,435,58,3993
Sao Paulo,30,1,1,0,not acept,920,0,12,932
Sao Paulo,251,4,4,3,acept,4200,1250,54,5504
Sao Paulo,77,2,1,1,acept,2600,100,33,2733
Sao Paulo,112,3,3,2,not acept,3250,486,42,3778
Campinas,273,4,2,2,acept,2470,366,32,2868
Rio de Janeiro,55,1,1,1,acept,1100,9,15,1124
Campinas,80,3,2,2,not acept,1800,83,23,1906
Sao Paulo,400,4,5,3,acept,15000,1750,226,16976
Rio de Janeiro,110,3,2,1,acept,2500,100,33,2633
Sao Paulo,262,4,5,4,acept,2250,1350,29,3629
Rio de Janeiro,38,1,1,0,not acept,1700,82,22,1804
Sao Paulo,140,2,2,1,not acept,12500,279,159,12938
Sao Paulo,110,6,5,7,acept,9810,1000,148,10958
Porto Alegre,46,1,1,1,acept,1099,55,17,1171
Porto Alegre,55,2,1,0,acept,1500,42,22,1564
Rio de Janeiro,70,2,1,1,not acept,1710,100,23,1833
Sao Paulo,60,2,2,1,acept,1860,0,24,1884
Sao Paulo,87,3,2,2,not acept,4000,250,51,4301
Porto Alegre,400,3,4,4,acept,12000,1100,214,13314
Porto Alegre,64,2,2,0,not acept,1350,52,20,1422
Rio de Janeiro,85,2,2,1,acept,9000,769,116,9885
Porto Alegre,140,3,4,2,acept,3490,292,51,3833
Sao Paulo,288,4,5,4,acept,5025,1155,64,6244
Sao Paulo,64,3,1,1,acept,1200,110,16,1326
Sao Paulo,62,2,2,1,not acept,5050,227,64,5341
Rio de Janeiro,15,1,1,0,acept,700,0,10,710
Sao Paulo,200,4,3,2,acept,4100,1615,52,5767
Belo Horizonte,450,4,3,4,acept,12750,717,170,13637
Sao Paulo,72,3,2,1,acept,3010,0,39,3049
Rio de Janeiro,75,2,1,1,acept,1750,42,23,1815
Sao Paulo,20,1,1,0,acept,550,30,9,589
Sao Paulo,77,2,2,1,acept,3000,80,39,3119
Sao Paulo,57,1,1,0,acept,6000,17,77,6094
Sao Paulo,103,3,3,0,acept,6000,320,77,6397
Sao Paulo,180,3,2,1,acept,12000,334,153,12487
Porto Alegre,80,2,1,1,acept,833,4,13,850
Sao Paulo,25,1,1,1,acept,4000,0,51,4051
Campinas,248,3,4,4,acept,8000,667,102,8769
Belo Horizonte,360,6,2,0,not acept,8000,752,132,8884
Sao Paulo,62,1,1,0,acept,2300,0,30,2330
Sao Paulo,85,2,1,0,acept,1800,0,23,1823
Porto Alegre,187,3,3,2,acept,2805,98,50,2953
Sao Paulo,58,2,3,2,not acept,2000,0,31,2031
Belo Horizonte,93,2,1,0,not acept,1600,70,22,1692
Sao Paulo,28,1,1,0,acept,1999,42,26,2067
Campinas,120,3,2,5,acept,1700,75,26,1801
Rio de Janeiro,70,1,2,0,not acept,1200,0,19,1219
Sao Paulo,162,2,3,3,not acept,15000,959,191,16150
Sao Paulo,210,3,2,3,acept,4700,0,71,4771
Belo Horizonte,300,3,2,2,acept,2500,224,41,2765
Sao Paulo,40,1,1,1,acept,1900,30,25,1955
Sao Paulo,270,3,4,4,acept,4800,928,61,5789
Sao Paulo,65,2,1,1,acept,3820,134,49,4003
Porto Alegre,83,2,2,1,acept,1400,67,21,1488
Sao Paulo,340,4,5,5,acept,7500,1917,96,9513
Belo Horizonte,28,1,1,1,not acept,890,65,12,967
Sao Paulo,70,1,1,0,acept,930,60,14,1004
Belo Horizonte,300,3,2,2,acept,4000,184,66,4250
Sao Paulo,423,4,5,7,acept,14000,2647,178,16825
Sao Paulo,16,1,1,0,not acept,850,35,11,896
Porto Alegre,38,1,1,0,acept,1300,53,19,1372
Belo Horizonte,210,4,4,4,acept,7000,146,94,7240
Sao Paulo,380,4,5,5,acept,3400,1125,44,4569
Rio de Janeiro,289,3,2,1,acept,5000,667,65,5732
Sao Paulo,28,1,1,0,acept,1300,0,17,1317
Campinas,83,2,3,1,acept,1500,42,20,1562
Sao Paulo,120,4,3,3,acept,3430,622,44,4096
Porto Alegre,60,2,2,1,acept,1080,88,16,1184
Sao Paulo,100,2,1,0,acept,1100,125,17,1242
Sao Paulo,108,4,3,2,acept,6500,609,83,7192
Sao Paulo,345,2,3,2,not acept,12000,783,153,12936
Sao Paulo,210,3,4,4,acept,10000,650,127,10777
Rio de Janeiro,80,2,1,0,acept,5300,34,69,5403
Sao Paulo,270,4,4,4,acept,2900,0,37,2937
Porto Alegre,60,2,1,0,acept,770,45,12,827
Rio de Janeiro,64,2,1,1,acept,2900,172,38,3110
Rio de Janeiro,90,2,2,0,not acept,4800,208,62,5070
Sao Paulo,157,3,3,1,acept,4500,347,58,4905
Campinas,100,3,2,1,acept,1300,76,17,1393
Campinas,86,3,2,2,acept,2340,81,30,2451
Sao Paulo,56,2,1,1,not acept,1800,9,23,1832
Rio de Janeiro,40,1,1,0,not acept,2900,137,38,3075
Sao Paulo,188,3,4,1,acept,10000,562,127,10689
Campinas,44,2,1,1,acept,1800,34,23,1857
Rio de Janeiro,300,3,2,0,acept,2970,709,39,3718
Rio de Janeiro,101,3,3,2,acept,5000,377,65,5442
Belo Horizonte,130,3,1,1,acept,2000,293,27,2320
Sao Paulo,120,4,3,3,acept,6160,390,79,6629
Sao Paulo,200,3,4,2,acept,2900,1100,44,4044
Sao Paulo,140,3,4,2,acept,8500,456,108,9064
Rio de Janeiro,100,3,1,0,acept,3399,217,44,3660
Sao Paulo,260,5,3,0,acept,5500,600,83,6183
Sao Paulo,77,2,2,2,acept,3000,203,39,3242
Campinas,45,1,1,0,acept,770,34,10,814
Porto Alegre,50,2,1,1,acept,1000,25,18,1043
Campinas,44,2,1,2,acept,908,24,12,944
Porto Alegre,84,1,2,0,acept,2200,0,33,2233
Belo Horizonte,53,3,1,0,acept,1000,68,14,1082
Sao Paulo,200,3,4,2,acept,3250,292,49,3591
Campinas,75,3,2,1,acept,900,0,12,912
Porto Alegre,120,2,2,1,acept,2525,75,37,2637
Belo Horizonte,70,2,1,0,not acept,1030,0,17,1047
Campinas,100,3,2,0,not acept,808,81,11,900
Porto Alegre,73,2,2,1,acept,2450,94,36,2580
Rio de Janeiro,70,2,1,1,not acept,3000,167,39,3206
Sao Paulo,110,2,4,2,acept,6375,500,81,6956
Sao Paulo,200,3,2,2,acept,3000,0,39,3039
Sao Paulo,75,2,2,2,acept,1198,227,16,1441
Sao Paulo,96,2,1,1,acept,3450,23,52,3525
Rio de Janeiro,270,3,2,1,not acept,4000,1000,52,5052
Sao Paulo,100,1,1,0,acept,2720,138,41,2899
Belo Horizonte,195,4,2,2,acept,3400,236,56,3692
Rio de Janeiro,102,3,2,0,not acept,3100,380,40,3520
Sao Paulo,310,4,4,8,acept,5500,521,83,6104
Sao Paulo,63,2,2,1,acept,1850,103,24,1977
Sao Paulo,131,3,2,2,not acept,3000,534,39,3573
Sao Paulo,37,1,1,1,not acept,2850,152,37,3039
Sao Paulo,145,3,2,2,acept,3000,128,46,3174
Sao Paulo,135,3,3,1,acept,4300,250,55,4605
Porto Alegre,67,3,2,1,acept,1399,56,21,1476
Sao Paulo,25,1,1,0,not acept,1049,31,14,1094
Belo Horizonte,300,4,4,4,acept,6200,343,102,6645
Sao Paulo,190,3,2,2,acept,5700,492,73,6265
Sao Paulo,105,3,2,2,acept,7300,275,93,7668
Sao Paulo,48,1,1,2,not acept,4500,248,58,4806
Porto Alegre,170,2,3,1,acept,1300,50,24,1374
Sao Paulo,75,3,2,1,not acept,2000,109,26,2135
Sao Paulo,520,3,4,8,not acept,10000,1008,151,11159
Rio de Janeiro,37,1,1,0,acept,1840,247,24,2111
Sao Paulo,305,3,6,3,acept,10000,1834,127,11961
Rio de Janeiro,80,2,2,1,acept,3776,167,49,3992
Campinas,69,2,2,1,acept,1800,130,23,1953
Sao Paulo,36,1,1,1,acept,1850,0,24,1874
Sao Paulo,28,1,1,0,acept,2150,0,28,2178
Porto Alegre,110,1,2,1,acept,2040,179,30,2249
Porto Alegre,88,2,1,0,acept,1300,27,19,1346
Sao Paulo,500,5,7,7,acept,11500,5500,173,17173
Sao Paulo,122,3,2,1,acept,3860,113,49,4022
Belo Horizonte,85,2,1,1,acept,1250,88,17,1355
Sao Paulo,36,1,1,0,acept,1600,30,21,1651
Belo Horizonte,80,3,2,1,acept,1900,195,26,2121
Sao Paulo,114,3,3,0,not acept,2289,542,29,2860
Belo Horizonte,150,3,2,2,acept,1600,240,22,1862
Sao Paulo,70,2,1,0,acept,1800,0,23,1823
Sao Paulo,370,4,4,3,acept,7900,1000,119,9019
Campinas,47,1,1,1,acept,2700,135,35,2870
Sao Paulo,70,3,2,2,not acept,2910,84,37,3031
Sao Paulo,70,2,2,2,acept,3300,84,42,3426
Sao Paulo,50,2,3,0,not acept,1740,84,27,1851
Rio de Janeiro,37,1,1,0,acept,1900,250,25,2175
Sao Paulo,136,3,2,2,acept,2800,252,36,3088
Rio de Janeiro,60,2,1,0,not acept,2000,185,26,2211
Sao Paulo,65,2,2,1,acept,1540,290,20,1850
Belo Horizonte,450,7,5,3,not acept,7880,292,130,8302
Sao Paulo,180,3,4,3,acept,3400,250,44,3694
Sao Paulo,130,3,3,2,acept,4000,292,51,4343
Sao Paulo,200,3,2,6,acept,2300,176,35,2511
Sao Paulo,180,2,3,2,acept,12500,0,159,12659
Belo Horizonte,55,2,2,1,not acept,1700,75,23,1798
Sao Paulo,79,2,1,2,acept,6250,0,80,6330
Sao Paulo,47,1,1,1,acept,9200,313,117,9630
Sao Paulo,65,2,1,1,acept,2550,109,33,2692
Campinas,292,4,4,3,acept,3750,424,48,4222
Belo Horizonte,181,4,2,2,acept,4000,434,54,4488
Sao Paulo,327,5,4,5,acept,11000,2000,166,13166
Sao Paulo,300,2,3,2,not acept,5120,500,65,5685
Sao Paulo,366,4,5,5,acept,15000,1834,191,17025
Rio de Janeiro,115,3,3,1,acept,3150,179,41,3370
Belo Horizonte,216,4,5,5,acept,7500,0,100,7600
Sao Paulo,70,2,1,1,not acept,820,45,11,876
Sao Paulo,170,3,3,2,acept,5000,242,76,5318
Sao Paulo,65,3,2,2,acept,3000,1,39,3040
Sao Paulo,88,3,3,2,acept,2900,190,37,3127
Sao Paulo,54,1,1,0,acept,1870,3,24,1897
Sao Paulo,95,1,2,2,acept,8000,566,102,8668
Sao Paulo,800,4,5,4,acept,15000,3334,191,18525
Sao Paulo,75,1,1,0,not acept,1450,0,22,1472
Rio de Janeiro,38,1,1,0,acept,1940,65,25,2030
Sao Paulo,178,2,4,3,acept,6000,70,77,6147
Sao Paulo,310,2,6,3,not acept,6000,764,77,6841
Sao Paulo,66,1,1,1,acept,2600,50,33,2683
Rio de Janeiro,90,3,2,0,acept,2550,142,33,2725
Sao Paulo,180,3,3,2,acept,4250,625,54,4929
Rio de Janeiro,40,1,1,0,acept,1100,20,15,1135
Sao Paulo,150,3,2,1,acept,5500,221,70,5791
Sao Paulo,37,1,1,0,not acept,2900,69,37,3006
Sao Paulo,71,2,2,1,acept,2800,234,36,3070
Sao Paulo,130,3,2,2,acept,5000,584,64,5648
Rio de Janeiro,75,2,2,1,acept,2700,145,35,2880
Sao Paulo,45,1,1,1,acept,1760,167,23,1950
Campinas,260,4,3,4,acept,5830,596,88,6514
Sao Paulo,50,1,1,0,not acept,750,0,12,762
Sao Paulo,63,2,2,1,not acept,1600,66,21,1687
Sao Paulo,99,2,1,1,not acept,4300,125,55,4480
Sao Paulo,170,4,4,3,acept,8250,594,105,8949
Belo Horizonte,67,2,2,1,acept,1612,59,22,1693
Sao Paulo,126,2,2,2,acept,2300,263,30,2593
Rio de Janeiro,70,2,2,2,acept,1700,265,22,1987
Rio de Janeiro,57,1,1,1,acept,1717,64,23,1804
Porto Alegre,27,1,1,0,not acept,694,13,11,718
Campinas,78,1,2,1,acept,1840,50,24,1914
Sao Paulo,1100,4,6,10,acept,14000,2000,211,16211
Sao Paulo,162,2,2,3,acept,15000,609,191,15800
Sao Paulo,85,2,2,2,acept,2550,290,33,2873
Rio de Janeiro,67,2,1,1,acept,1100,60,15,1175
Rio de Janeiro,122,3,1,0,acept,2000,220,26,2246
Sao Paulo,220,4,3,4,acept,11000,1000,140,12140
Sao Paulo,30,1,1,0,not acept,1000,0,13,1013
Sao Paulo,50,1,1,0,acept,950,0,15,965
Belo Horizonte,120,3,2,2,not acept,1500,81,20,1601
Rio de Janeiro,75,2,2,1,acept,1500,0,12,1512
Sao Paulo,70,2,2,2,acept,2700,102,35,2837
Sao Paulo,650,4,6,6,acept,8500,1600,128,10228
Porto Alegre,71,3,2,1,acept,1300,48,19,1367
Sao Paulo,27,1,1,0,acept,2000,0,26,2026
Sao Paulo,187,3,3,2,acept,2950,342,38,3330
Sao Paulo,110,3,2,1,acept,4500,0,58,4558
Sao Paulo,180,4,2,2,acept,3500,150,53,3703
Sao Paulo,57,2,2,2,acept,1510,190,20,1720
Sao Paulo,250,3,2,2,acept,15000,459,226,15685
Sao Paulo,49,2,2,1,acept,1460,100,19,1579
Sao Paulo,110,1,1,1,acept,1300,250,20,1570
Sao Paulo,59,2,2,1,acept,2200,18,28,2246
Sao Paulo,65,2,1,1,acept,1700,34,22,1756
Sao Paulo,220,4,2,2,acept,5000,692,64,5756
Sao Paulo,220,3,2,2,acept,6400,700,82,7182
Sao Paulo,88,2,2,1,acept,7300,0,93,7393
Sao Paulo,90,3,2,2,acept,4100,300,62,4462
Sao Paulo,30,1,1,0,acept,3400,0,44,3444
Sao Paulo,49,2,1,1,acept,1800,0,23,1823
Rio de Janeiro,100,3,2,0,acept,5900,309,77,6286
Rio de Janeiro,120,3,1,1,acept,2300,209,30,2539
Sao Paulo,150,2,3,3,acept,4250,0,64,4314
Belo Horizonte,100,3,2,0,acept,1550,125,26,1701
Sao Paulo,170,3,3,0,acept,7500,529,96,8125
Campinas,70,2,1,2,acept,1300,70,20,1390
Sao Paulo,70,1,1,1,not acept,3150,120,40,3310
Sao Paulo,80,1,1,1,acept,6500,0,83,6583
Sao Paulo,60,2,2,1,acept,5700,212,73,5985
Sao Paulo,100,3,3,3,acept,3300,417,42,3759
Sao Paulo,260,4,2,3,acept,3850,430,58,4338
Sao Paulo,300,3,5,4,acept,6500,853,98,7451
Sao Paulo,86,3,3,2,not acept,2500,200,32,2732
Sao Paulo,250,4,4,2,not acept,6600,0,100,6700
Porto Alegre,48,1,1,0,acept,900,542,14,1456
Belo Horizonte,70,3,2,2,acept,1900,228,26,2154
Sao Paulo,82,3,2,2,acept,2100,252,27,2379
Sao Paulo,80,3,2,1,acept,1900,164,25,2089
Porto Alegre,429,5,4,5,acept,10500,334,187,11021
Campinas,104,2,2,1,acept,1700,122,22,1844
Rio de Janeiro,35,1,1,0,not acept,2600,96,34,2730
Sao Paulo,240,4,2,1,acept,4500,217,58,4775
Sao Paulo,40,1,1,0,not acept,850,41,11,902
Sao Paulo,400,3,3,2,not acept,12000,0,181,12181
Sao Paulo,90,2,2,2,acept,4500,36,58,4594
Sao Paulo,45,2,1,1,not acept,1720,91,22,1833
Rio de Janeiro,110,3,2,0,acept,2000,60,31,2091
Rio de Janeiro,110,4,2,2,acept,1900,380,25,2305
Porto Alegre,143,2,1,2,acept,2500,184,37,2721
Sao Paulo,60,2,2,2,acept,1100,210,14,1324
Sao Paulo,124,3,3,2,acept,2791,339,36,3166
Sao Paulo,55,2,1,1,acept,1490,21,19,1530
Sao Paulo,73,3,2,2,acept,2500,283,32,2815
Belo Horizonte,200,4,4,2,acept,4100,500,55,4655
Porto Alegre,70,1,1,0,not acept,850,46,13,909
Sao Paulo,44,1,1,0,acept,2600,0,33,2633
Rio de Janeiro,87,2,1,1,acept,2500,209,33,2742
Porto Alegre,60,1,1,1,not acept,1290,35,19,1344
Sao Paulo,200,3,5,3,acept,4350,584,56,4990
Sao Paulo,80,2,1,1,not acept,2900,0,37,2937
Porto Alegre,51,2,1,1,acept,1080,25,16,1121
Sao Paulo,147,2,3,2,not acept,12000,500,153,12653
Belo Horizonte,210,3,4,3,not acept,10000,685,134,10819
Sao Paulo,110,3,2,2,acept,3200,0,41,3241
Porto Alegre,50,1,1,0,acept,1100,46,17,1163
Rio de Janeiro,32,1,1,0,acept,1430,62,19,1511
Belo Horizonte,82,3,2,1,acept,1000,64,14,1078
Sao Paulo,98,3,3,2,acept,2100,334,27,2461
Rio de Janeiro,170,4,3,2,acept,9000,667,116,9783
Sao Paulo,20,1,1,0,acept,1800,130,23,1953
Belo Horizonte,168,4,3,2,not acept,2000,108,27,2135
Rio de Janeiro,50,2,1,0,acept,800,62,11,873
Sao Paulo,212,4,4,3,not acept,9200,1046,117,10363
Sao Paulo,73,2,2,1,acept,1250,150,16,1416
Sao Paulo,50,1,1,1,acept,1800,0,23,1823
Sao Paulo,20,1,1,0,acept,1800,130,23,1953
Belo Horizonte,190,1,1,1,not acept,3900,162,64,4126
Sao Paulo,450,4,6,2,acept,4900,486,74,5460
Belo Horizonte,180,5,5,4,acept,4500,270,74,4844
Belo Horizonte,682,6,7,6,acept,5500,428,91,6019
Rio de Janeiro,68,2,1,0,acept,1000,400,13,1413
Porto Alegre,58,2,1,0,acept,1300,0,19,1319
Belo Horizonte,60,3,2,1,acept,1100,83,15,1198
Campinas,50,1,1,1,not acept,1160,185,15,1360
Belo Horizonte,120,3,3,1,acept,2200,145,30,2375
Sao Paulo,43,2,1,1,acept,2000,0,26,2026
Sao Paulo,91,1,2,2,acept,13000,334,165,13499
Campinas,75,2,1,2,acept,1600,135,21,1756
Sao Paulo,300,4,3,4,acept,6000,1500,77,7577
Campinas,74,2,2,2,acept,4920,0,63,4983
Belo Horizonte,90,3,2,2,acept,1550,84,21,1655
Belo Horizonte,154,4,4,3,acept,8500,153,114,8767
Sao Paulo,280,3,3,7,acept,8670,450,131,9251
Sao Paulo,150,3,3,2,acept,4000,515,51,4566
Sao Paulo,20,1,1,0,acept,1800,130,23,1953
Sao Paulo,110,2,2,0,acept,2690,0,35,2725
Sao Paulo,247,4,4,4,acept,2550,684,33,3267
Sao Paulo,220,3,4,2,acept,15000,834,226,16060
Sao Paulo,70,2,2,0,not acept,3800,90,58,3948
Sao Paulo,98,3,2,2,acept,1760,383,23,2166
Sao Paulo,300,4,6,6,acept,15000,3400,191,18591
Porto Alegre,80,2,1,1,acept,4000,212,59,4271
Sao Paulo,57,2,1,2,acept,1450,69,19,1538
Sao Paulo,75,2,1,0,not acept,1200,67,16,1283
Rio de Janeiro,70,2,2,1,not acept,2300,75,30,2405
Sao Paulo,80,2,1,0,acept,1700,0,22,1722
Sao Paulo,372,5,4,6,acept,9200,1041,139,10380
Sao Paulo,120,3,2,2,not acept,4500,238,58,4796
Campinas,71,1,1,1,not acept,750,56,10,816
Sao Paulo,130,3,3,2,acept,3500,342,45,3887
Sao Paulo,300,2,1,2,acept,2800,350,43,3193
Belo Horizonte,320,5,4,3,acept,3400,220,46,3666
Belo Horizonte,200,3,2,2,acept,12000,369,197,12566
Porto Alegre,56,2,2,1,acept,1600,84,24,1708
Sao Paulo,165,3,2,3,acept,3730,955,48,4733
Sao Paulo,35,1,1,0,not acept,1290,0,17,1307
Belo Horizonte,96,3,1,1,acept,2200,154,30,2384
Campinas,450,4,5,4,acept,6500,230,98,6828
Sao Paulo,227,4,4,3,acept,6900,1534,88,8522
Sao Paulo,40,1,1,1,acept,2600,25,33,2658
Sao Paulo,288,4,5,4,acept,6000,1150,77,7227
Belo Horizonte,90,1,2,0,acept,1300,54,18,1372
Sao Paulo,45,2,1,1,not acept,1290,0,17,1307
Sao Paulo,63,2,2,1,not acept,2800,149,36,2985
Belo Horizonte,120,3,2,2,acept,2200,120,37,2357
Sao Paulo,94,3,2,2,not acept,7150,341,91,7582
Porto Alegre,60,1,1,1,acept,500,10,8,518
Porto Alegre,106,3,2,2,not acept,4000,100,59,4159
Sao Paulo,167,3,4,2,acept,2900,732,37,3669
Belo Horizonte,69,2,3,2,acept,2600,172,35,2807
Rio de Janeiro,300,4,4,1,acept,3400,292,52,3744
Sao Paulo,50,2,1,0,acept,2473,3,32,2508
Porto Alegre,40,1,1,0,acept,850,42,13,905
Sao Paulo,380,4,3,3,acept,5800,1600,74,7474
Rio de Janeiro,20,1,1,0,not acept,750,0,10,760
Campinas,50,2,1,1,acept,950,43,13,1006
Sao Paulo,60,2,2,1,acept,4500,50,58,4608
Sao Paulo,40,1,1,1,acept,3470,70,44,3584
Sao Paulo,62,2,2,1,acept,1730,22,22,1774
Rio de Janeiro,230,3,3,0,acept,7200,667,93,7960
Campinas,45,2,1,1,acept,870,0,12,882
Porto Alegre,60,2,1,0,acept,730,20,11,761
Sao Paulo,65,2,2,1,not acept,1039,42,14,1095
Rio de Janeiro,90,3,1,0,not acept,2710,8,35,2753
Sao Paulo,150,3,3,2,acept,3400,325,52,3777
Sao Paulo,180,3,4,3,not acept,4330,1228,55,5613
Belo Horizonte,95,3,2,2,not acept,1650,145,22,1817
Rio de Janeiro,45,1,1,0,not acept,2200,50,29,2279
Sao Paulo,216,3,5,0,not acept,15000,1500,191,16691
Campinas,58,1,1,0,acept,900,66,12,978
Sao Paulo,42,1,1,0,acept,3256,0,42,3298
Porto Alegre,40,1,1,0,acept,750,42,11,803
Sao Paulo,220,4,4,3,not acept,4930,809,63,5802
Belo Horizonte,42,1,1,1,not acept,2690,172,36,2898
Rio de Janeiro,421,3,3,1,acept,10000,834,129,10963
Campinas,226,4,2,2,acept,3000,403,39,3442
Sao Paulo,55,1,1,0,acept,1400,0,18,1418
Porto Alegre,61,1,1,1,acept,2200,67,33,2300
Rio de Janeiro,50,1,1,0,not acept,1000,184,13,1197
Sao Paulo,300,4,4,0,acept,9600,500,122,10222
Porto Alegre,58,2,2,2,acept,2550,0,38,2588
Porto Alegre,104,3,3,2,acept,3900,200,57,4157
Rio de Janeiro,72,2,2,0,acept,2500,200,33,2733
Campinas,65,3,1,1,acept,1100,1500,14,2614
Sao Paulo,160,4,2,2,acept,4900,460,63,5423
Campinas,40,1,1,0,acept,730,11,10,751
Sao Paulo,23,1,1,1,acept,2300,59,30,2389
Sao Paulo,35,1,1,0,not acept,900,50,14,964
Porto Alegre,28,1,1,0,acept,840,50,13,903
Sao Paulo,20,1,1,0,acept,1800,130,23,1953
Sao Paulo,68,2,2,1,acept,1880,189,24,2093
Campinas,70,3,1,1,acept,1200,0,16,1216
Sao Paulo,127,2,3,2,acept,3800,292,49,4141
Sao Paulo,138,3,2,3,acept,5200,231,79,5510
Campinas,53,1,1,1,acept,550,73,7,630
Sao Paulo,130,5,2,0,acept,3000,37,39,3076
Porto Alegre,39,1,1,1,acept,800,11,12,823
Porto Alegre,60,2,1,0,acept,980,8,15,1003
Sao Paulo,300,4,4,4,not acept,1400,834,18,2252
Sao Paulo,500,3,3,5,acept,8500,534,128,9162
Campinas,90,3,2,1,acept,1600,76,21,1697
Campinas,120,3,1,2,acept,1790,150,23,1963
Sao Paulo,134,3,5,2,acept,4900,0,63,4963
Campinas,78,2,1,1,acept,1300,106,17,1423
Sao Paulo,55,1,1,1,not acept,4300,21,55,4376
Sao Paulo,167,3,3,2,acept,5500,292,70,5862
Sao Paulo,15,1,1,0,not acept,1200,0,16,1216
Belo Horizonte,46,2,1,1,acept,1050,27,14,1091
Rio de Janeiro,30,1,1,0,not acept,4000,67,52,4119
Rio de Janeiro,60,2,2,1,acept,2198,125,29,2352
Sao Paulo,380,3,3,4,acept,4200,300,64,4564
Belo Horizonte,95,3,2,1,acept,1400,129,19,1548
Sao Paulo,55,2,2,1,acept,1850,0,24,1874
Belo Horizonte,55,2,1,1,not acept,850,0,12,862
Rio de Janeiro,30,1,1,0,not acept,1140,0,15,1155
Rio de Janeiro,58,2,1,0,not acept,4000,200,52,4252
Sao Paulo,480,4,5,2,acept,6000,2308,91,8399
Sao Paulo,97,3,2,2,acept,2100,29,27,2156
Sao Paulo,33,1,1,1,not acept,1300,155,17,1472
Sao Paulo,192,3,4,2,acept,8500,0,108,8608
Rio de Janeiro,114,4,2,1,acept,3000,450,39,3489
Sao Paulo,70,2,2,0,not acept,4000,50,51,4101
Campinas,240,3,4,4,acept,7000,0,89,7089
Porto Alegre,110,3,1,0,acept,1850,80,28,1958
Rio de Janeiro,950,6,5,2,not acept,13000,1500,198,14698
Sao Paulo,55,1,1,1,not acept,3200,0,41,3241
Campinas,166,4,3,3,acept,2050,284,26,2360
Porto Alegre,117,3,3,2,acept,4000,329,59,4388
Campinas,115,3,2,1,acept,1364,91,5,1460
Campinas,55,2,1,1,acept,940,20,12,972
Sao Paulo,85,1,2,1,acept,2800,92,36,2928
Sao Paulo,61,1,2,1,acept,2270,25,29,2324
Sao Paulo,34,1,1,0,acept,2600,74,33,2707
Porto Alegre,70,3,2,0,acept,1500,0,22,1522
Sao Paulo,85,2,2,0,acept,6000,250,43,6293
Sao Paulo,93,2,1,1,not acept,5500,110,70,5680
Sao Paulo,150,3,2,1,acept,3600,310,46,3956
Sao Paulo,48,2,1,1,acept,1740,135,23,1898
Belo Horizonte,70,2,1,0,acept,1200,42,16,1258
Campinas,80,2,2,1,acept,3000,107,39,3146
Sao Paulo,137,3,3,3,acept,9800,417,125,10342
Sao Paulo,230,3,4,3,acept,12000,157,153,12310
Sao Paulo,95,3,2,1,not acept,4300,380,55,4735
Rio de Janeiro,87,2,2,1,not acept,1950,219,26,2195
Belo Horizonte,800,8,7,4,acept,14000,834,230,15064
Sao Paulo,88,3,1,2,acept,1400,35,18,1453
Sao Paulo,245,3,3,1,acept,12000,486,153,12639
Sao Paulo,34,1,1,0,not acept,2800,74,36,2910
Sao Paulo,469,4,5,4,acept,15000,2260,191,17451
Rio de Janeiro,113,2,2,1,acept,8000,501,104,8605
Belo Horizonte,200,4,4,3,acept,4000,475,54,4529
Rio de Janeiro,44,1,1,0,acept,1700,86,22,1808
Sao Paulo,45,2,1,1,acept,1440,0,19,1459
Sao Paulo,63,2,2,1,acept,1850,103,24,1977
Porto Alegre,58,1,1,0,acept,867,42,13,922
Sao Paulo,55,2,2,1,acept,2500,199,32,2731
Sao Paulo,320,4,4,2,acept,8000,645,102,8747
Belo Horizonte,57,1,1,1,not acept,1400,158,19,1577
Sao Paulo,240,5,2,3,not acept,6500,290,98,6888
Sao Paulo,127,3,2,1,acept,3300,400,42,3742
Sao Paulo,18,1,1,0,acept,1710,0,22,1732
Campinas,35,1,1,0,acept,500,14,7,521
Sao Paulo,320,3,5,3,acept,9000,0,136,9136
Campinas,46,1,1,0,acept,500,14,7,521
Sao Paulo,130,3,2,1,acept,6290,233,80,6603
Sao Paulo,37,1,1,0,acept,1625,0,25,1650
Campinas,136,3,4,2,not acept,2500,131,32,2663
Sao Paulo,81,2,2,1,not acept,1400,71,18,1489
Sao Paulo,38,1,1,0,not acept,1450,0,19,1469
Sao Paulo,198,3,4,2,acept,2500,259,38,2797
Belo Horizonte,220,5,4,4,acept,2700,170,36,2906
Sao Paulo,125,3,4,1,acept,4900,0,63,4963
Sao Paulo,450,4,6,4,acept,15000,2500,191,17691
Sao Paulo,145,3,2,2,acept,3000,546,39,3585
Belo Horizonte,70,3,1,2,acept,1600,667,22,2289
Porto Alegre,140,3,4,3,acept,8000,550,117,8667
Sao Paulo,100,3,2,1,acept,1930,100,25,2055
Sao Paulo,39,1,1,0,not acept,1300,0,17,1317
Rio de Janeiro,98,2,2,1,not acept,3500,225,46,3771
Sao Paulo,367,4,5,3,not acept,8500,1167,108,9775
Sao Paulo,61,2,2,1,acept,4200,134,54,4388
Belo Horizonte,66,2,2,1,acept,2100,226,28,2354
Sao Paulo,235,3,3,0,acept,8300,709,106,9115
Campinas,110,3,3,2,acept,3200,88,49,3337
Sao Paulo,84,3,2,1,acept,2200,25,28,2253
Sao Paulo,165,3,1,3,acept,3400,384,52,3836
Belo Horizonte,90,2,1,0,acept,1320,70,22,1412
Sao Paulo,48,1,1,0,not acept,1150,34,18,1202
Porto Alegre,60,2,1,1,not acept,950,34,17,1001
Sao Paulo,92,3,2,2,acept,3300,318,42,3660
Rio de Janeiro,80,3,1,1,acept,3000,213,39,3252
Belo Horizonte,25,1,1,0,not acept,650,0,9,659
Sao Paulo,220,4,4,4,acept,5500,832,70,6402
Campinas,74,2,3,1,acept,1584,118,6,1708
Sao Paulo,98,2,2,0,acept,2500,0,32,2532
Sao Paulo,69,2,2,1,acept,1400,18,18,1436
Sao Paulo,90,2,1,1,acept,2500,219,38,2757
Rio de Janeiro,105,2,2,0,acept,3430,174,45,3649
Sao Paulo,400,3,4,4,acept,12000,1667,181,13848
Sao Paulo,110,2,2,2,not acept,2700,300,41,3041
Sao Paulo,245,3,4,3,acept,14000,917,178,15095
Belo Horizonte,60,1,1,1,acept,3000,0,40,3040
Porto Alegre,40,1,1,0,acept,800,46,12,858
Porto Alegre,35,1,1,1,not acept,1400,0,21,1421
Sao Paulo,35,1,1,0,not acept,2595,0,33,2628
Sao Paulo,500,3,2,8,acept,4000,632,61,4693
Sao Paulo,30,1,1,0,not acept,1650,0,25,1675
Belo Horizonte,200,3,3,0,acept,1800,0,30,1830
Sao Paulo,33,1,1,1,not acept,1464,313,19,1796
Porto Alegre,47,1,1,1,not acept,2200,0,33,2233
Sao Paulo,50,1,1,0,acept,810,34,13,857
Sao Paulo,54,2,2,2,acept,2400,103,31,2534
Rio de Janeiro,60,2,1,0,acept,2500,34,33,2567
Sao Paulo,36,1,1,1,not acept,2300,105,30,2435
Belo Horizonte,205,4,4,4,acept,5000,796,67,5863
Rio de Janeiro,625,5,3,2,acept,15000,1250,229,16479
Campinas,60,2,1,1,acept,900,48,12,960
Sao Paulo,50,1,1,0,not acept,2480,20,32,2532
Sao Paulo,185,2,3,3,acept,5500,834,70,6404
Sao Paulo,256,3,4,4,acept,7000,1000,89,8089
Sao Paulo,170,3,3,2,acept,9500,828,121,10449
Porto Alegre,90,3,1,0,acept,1500,5,22,1527
Belo Horizonte,110,2,3,0,acept,3500,125,47,3672
Campinas,89,3,2,2,acept,1897,176,25,2098
Sao Paulo,54,1,1,1,acept,3600,149,46,3795
Sao Paulo,113,3,2,2,acept,2990,22,45,3057
Sao Paulo,100,3,1,1,acept,3000,92,39,3131
Sao Paulo,400,4,6,5,not acept,8160,2084,104,10348
Sao Paulo,65,2,1,1,not acept,1600,0,21,1621
Porto Alegre,65,3,2,1,acept,1980,46,29,2055
Sao Paulo,50,1,1,1,acept,2000,382,26,2408
Rio de Janeiro,150,3,3,1,acept,4800,180,62,5042
Rio de Janeiro,170,4,3,4,acept,2350,576,31,2957
Belo Horizonte,164,4,2,2,acept,3500,144,47,3691
Campinas,470,3,4,0,acept,7900,900,119,8919
Sao Paulo,430,4,6,2,acept,3378,286,43,3707
Sao Paulo,108,3,3,2,acept,2800,209,43,3052
Belo Horizonte,75,2,2,1,acept,1300,98,18,1416
Porto Alegre,200,4,3,1,acept,4050,250,72,4372
Belo Horizonte,32,1,1,1,acept,850,67,12,929
Rio de Janeiro,40,1,1,0,not acept,2500,59,33,2592
Sao Paulo,360,4,5,4,acept,12750,2779,162,15691
Belo Horizonte,55,1,1,1,not acept,3450,250,46,3746
Rio de Janeiro,30,1,1,0,not acept,2030,66,27,2123
Sao Paulo,59,2,1,1,acept,1640,40,21,1701
Rio de Janeiro,120,3,2,1,acept,3300,231,43,3574
Sao Paulo,78,3,2,2,acept,2000,292,31,2323
Rio de Janeiro,95,2,3,0,acept,6020,250,78,6348
Sao Paulo,180,3,3,1,acept,5000,192,64,5256
Sao Paulo,91,2,3,2,acept,4675,417,60,5152
Campinas,70,2,1,1,not acept,1800,1,23,1824
Sao Paulo,315,3,5,4,acept,5820,1495,74,7389
Rio de Janeiro,56,2,1,1,not acept,2800,249,37,3086
Sao Paulo,480,4,3,3,acept,13500,834,203,14537
Sao Paulo,400,3,3,6,acept,15000,1123,226,16349
Belo Horizonte,83,4,2,2,acept,1500,225,20,1745
Porto Alegre,47,1,1,1,not acept,2200,0,33,2233
Sao Paulo,90,2,1,1,not acept,1450,34,22,1506
Porto Alegre,131,3,2,1,acept,2500,125,37,2662
Sao Paulo,700,5,7,3,acept,13000,1084,196,14280
Belo Horizonte,180,3,2,0,acept,3200,359,53,3612
Campinas,60,2,1,0,acept,1134,55,15,1204
Porto Alegre,50,1,1,1,not acept,1300,68,19,1387
Campinas,200,3,2,3,acept,2500,600,38,3138
Rio de Janeiro,80,4,3,1,not acept,3000,202,39,3241
Campinas,54,2,1,1,acept,1580,69,21,1670
Sao Paulo,150,3,2,1,acept,6000,284,77,6361
Sao Paulo,129,3,3,1,acept,2300,78,30,2408
Sao Paulo,200,3,2,1,acept,8500,417,108,9025
Rio de Janeiro,65,1,1,0,acept,1800,30,24,1854
Sao Paulo,210,4,2,2,acept,8000,684,121,8805
Rio de Janeiro,115,3,2,2,acept,2850,141,37,3028
Belo Horizonte,350,4,5,5,acept,5000,1341,67,6408
Rio de Janeiro,55,1,1,0,acept,1500,85,23,1608
Sao Paulo,46,1,1,0,not acept,4300,292,31,4623
Rio de Janeiro,160,3,2,1,not acept,3100,350,40,3490
Belo Horizonte,230,4,4,4,acept,6000,1250,80,7330
Sao Paulo,180,4,4,4,not acept,10000,1000,127,11127
Sao Paulo,440,4,3,7,not acept,15000,1084,226,16310
Sao Paulo,90,2,2,1,acept,3000,50,39,3089
Campinas,45,1,1,0,not acept,500,0,7,507
Sao Paulo,77,3,1,1,acept,3000,117,39,3156
Sao Paulo,25,1,1,0,not acept,1000,84,13,1097
Sao Paulo,65,3,1,1,acept,1380,115,18,1513
Porto Alegre,60,2,2,0,acept,1085,55,16,1156
Belo Horizonte,50,2,1,1,acept,799,67,11,877
Sao Paulo,103,3,2,2,acept,1600,465,21,2086
Sao Paulo,35,5,1,0,acept,2500,200,38,2738
Porto Alegre,121,2,1,2,acept,1200,75,18,1293
Sao Paulo,307,4,6,4,acept,9100,1839,137,11076
Rio de Janeiro,150,3,2,2,acept,6800,594,88,7482
Porto Alegre,98,2,3,2,acept,2200,167,33,2400
Sao Paulo,16,1,1,0,not acept,850,59,11,920
Belo Horizonte,45,1,1,1,acept,2800,142,38,2980
Rio de Janeiro,45,2,1,0,acept,1300,15,17,1332
Rio de Janeiro,70,3,1,1,acept,1200,0,16,1216
Sao Paulo,200,4,2,2,acept,6500,500,98,7098
Rio de Janeiro,155,3,2,1,acept,3800,279,49,4128
Sao Paulo,35,1,1,1,acept,1020,30,13,1063
Campinas,60,3,2,1,acept,800,50,11,861
Sao Paulo,35,1,1,0,acept,874,30,12,916
Sao Paulo,67,2,2,1,not acept,3500,60,45,3605
Sao Paulo,38,1,1,0,acept,1380,67,18,1465
Belo Horizonte,190,4,4,4,acept,7700,1058,103,8861
Sao Paulo,45,1,1,1,acept,1300,59,20,1379
Campinas,600,5,5,4,acept,5000,916,76,5992
Sao Paulo,27,1,1,1,not acept,3700,0,47,3747
Sao Paulo,160,3,2,2,acept,3500,132,53,3685
Belo Horizonte,320,4,6,4,acept,12000,782,160,12942
Sao Paulo,41,1,1,1,acept,2680,110,41,2831
Sao Paulo,60,1,1,1,acept,3900,109,50,4059
Sao Paulo,66,1,1,1,not acept,3500,65,45,3610
Rio de Janeiro,41,1,1,0,acept,1700,85,22,1807
Sao Paulo,98,2,3,3,not acept,4150,375,53,4578
Sao Paulo,75,2,1,0,acept,1283,0,17,1300
Rio de Janeiro,62,2,1,0,acept,1700,97,22,1819
Sao Paulo,120,2,1,1,not acept,1300,50,20,1370
Sao Paulo,98,1,2,2,acept,4000,422,51,4473
Sao Paulo,380,4,5,4,acept,10500,815,158,11473
Sao Paulo,45,1,1,1,not acept,1800,177,23,2000
Belo Horizonte,65,2,1,1,acept,800,17,11,828
Sao Paulo,88,2,1,1,acept,3400,150,44,3594
Sao Paulo,250,3,4,2,acept,3000,233,46,3279
Campinas,108,1,3,2,acept,4500,0,58,4558
Sao Paulo,160,3,2,2,acept,3900,221,50,4171
Sao Paulo,70,2,1,0,acept,1300,50,20,1370
Sao Paulo,320,4,5,5,acept,10870,1417,164,12451
Sao Paulo,68,3,1,1,not acept,1600,0,7,1607
Rio de Janeiro,130,3,2,1,acept,4500,150,58,4708
Sao Paulo,600,3,3,3,acept,15000,2860,191,18051
Porto Alegre,127,3,2,2,acept,2900,220,43,3163
Rio de Janeiro,200,4,4,4,acept,2650,283,41,2974
Sao Paulo,90,3,2,2,acept,2800,234,36,3070
Sao Paulo,135,2,1,0,not acept,2000,5,26,2031
Porto Alegre,70,2,2,0,acept,3100,50,46,3196
Sao Paulo,46,1,1,1,acept,3000,133,39,3172
Sao Paulo,20,1,1,0,not acept,2060,0,27,2087
Sao Paulo,350,3,6,4,acept,8500,1035,108,9643
Rio de Janeiro,45,1,1,1,acept,1900,109,25,2034
Rio de Janeiro,223,3,3,0,not acept,765,350,10,1125
Porto Alegre,115,1,2,2,acept,1550,177,23,1750
Belo Horizonte,85,3,2,1,acept,1450,73,20,1543
Campinas,63,2,1,1,acept,840,90,11,941
Belo Horizonte,69,3,2,1,not acept,1600,90,22,1712
Sao Paulo,48,2,1,1,acept,900,0,12,912
Rio de Janeiro,400,5,4,2,acept,8000,34,104,8138
Sao Paulo,49,2,1,1,not acept,1250,0,16,1266
Sao Paulo,120,4,2,2,not acept,4500,89,68,4657
Sao Paulo,168,3,4,3,acept,7300,1000,93,8393
Rio de Janeiro,80,3,1,0,acept,2700,167,35,2902
Sao Paulo,100,2,4,2,acept,5990,417,76,6483
Sao Paulo,38,1,1,1,acept,2863,0,37,2900
Porto Alegre,45,1,1,0,not acept,550,0,9,559
Sao Paulo,123,3,3,0,acept,4000,42,61,4103
Sao Paulo,200,4,2,3,not acept,2390,267,31,2688
Campinas,73,3,1,1,acept,1140,100,15,1255
Sao Paulo,80,2,1,1,not acept,7450,98,95,7643
Rio de Janeiro,185,4,3,3,acept,11340,1835,147,13322
Sao Paulo,100,3,3,4,not acept,9775,0,147,9922
Sao Paulo,240,3,3,2,acept,4350,385,66,4801
Rio de Janeiro,405,4,3,2,acept,14000,1649,181,15830
Sao Paulo,130,3,4,4,acept,3280,490,50,3820
Porto Alegre,129,2,3,1,acept,1925,61,29,2015
Sao Paulo,130,2,2,2,not acept,2700,123,41,2864
Porto Alegre,73,2,1,1,acept,2500,50,37,2587
Campinas,50,2,1,1,acept,1200,109,16,1325
Belo Horizonte,90,3,2,1,acept,1859,124,7,1990
Sao Paulo,25,1,1,0,not acept,1050,84,14,1148
Sao Paulo,556,4,5,7,acept,7000,2059,106,9165
Sao Paulo,23,1,1,0,not acept,950,34,13,997
Porto Alegre,110,2,2,0,not acept,3500,0,52,3552
Sao Paulo,350,4,3,3,not acept,15000,0,191,15191
Campinas,300,4,3,5,acept,4100,20,62,4182
Sao Paulo,20,1,1,0,not acept,2050,0,26,2076
Belo Horizonte,31,1,1,1,not acept,460,92,7,559
Sao Paulo,250,4,3,3,acept,4350,250,66,4666
Belo Horizonte,200,4,2,2,acept,4300,429,58,4787
Sao Paulo,500,4,7,6,not acept,5000,4000,64,9064
Rio de Janeiro,105,3,2,0,not acept,5660,0,73,5733
Sao Paulo,320,5,3,8,acept,14000,917,211,15128
Sao Paulo,236,4,4,0,acept,3500,985,45,4530
Sao Paulo,50,1,1,0,not acept,3100,85,12,3197
Rio de Janeiro,65,2,1,0,acept,1130,0,15,1145
Belo Horizonte,502,4,3,4,acept,6500,436,107,7043
Sao Paulo,160,3,3,2,acept,6700,295,101,7096
Sao Paulo,90,2,2,1,acept,1950,125,30,2105
Campinas,44,1,1,1,acept,1200,74,16,1290
Sao Paulo,200,4,7,4,acept,8000,575,121,8696
Sao Paulo,150,3,2,0,acept,1700,210,22,1932
Campinas,578,4,5,8,acept,9500,787,143,10430
Sao Paulo,85,3,2,1,acept,3560,150,46,3756
Sao Paulo,67,1,1,1,not acept,1000,0,6,1006
Belo Horizonte,900,6,6,6,acept,5570,1084,92,6746
Sao Paulo,182,4,4,3,acept,3400,542,44,3986
Belo Horizonte,54,2,1,1,acept,800,58,11,869
Sao Paulo,33,1,1,0,acept,1650,0,21,1671
Sao Paulo,236,4,5,4,not acept,15000,142,191,15333
Sao Paulo,33,1,1,1,acept,1630,9,21,1660
Sao Paulo,25,1,1,0,acept,1800,0,23,1823
Porto Alegre,400,4,4,6,acept,7000,209,125,7334
Rio de Janeiro,130,4,2,2,acept,4200,592,55,4847
Sao Paulo,240,4,3,3,not acept,15000,1813,191,17004
Sao Paulo,190,4,3,2,acept,7700,1305,98,9103
Sao Paulo,42,1,1,1,acept,2100,107,27,2234
Sao Paulo,112,2,3,2,acept,3580,418,46,4044
Porto Alegre,108,3,2,2,not acept,3100,92,46,3238
Rio de Janeiro,50,1,1,0,not acept,1100,38,15,1153
Belo Horizonte,60,2,1,1,acept,1040,0,14,1054
Sao Paulo,60,3,1,1,acept,1480,0,19,1499
Sao Paulo,462,4,4,0,acept,10000,2700,151,12851
Sao Paulo,70,1,2,2,acept,4500,292,58,4850
Sao Paulo,72,2,1,1,acept,2300,0,30,2330
Sao Paulo,320,4,5,0,acept,8700,2300,142,11142
Belo Horizonte,140,2,2,2,acept,1600,99,22,1721
Campinas,60,1,1,0,acept,1300,75,17,1392
Sao Paulo,114,5,3,1,acept,6000,42,91,6133
Rio de Janeiro,40,1,1,0,acept,2000,90,26,2116
Sao Paulo,76,1,1,1,not acept,5015,185,64,5264
Sao Paulo,170,3,5,3,acept,2800,600,36,3436
Belo Horizonte,156,4,2,2,not acept,2700,189,36,2925
Campinas,65,2,1,1,not acept,1000,34,13,1047
Porto Alegre,67,1,1,1,acept,840,25,13,878
Porto Alegre,110,3,2,1,not acept,2300,75,34,2409
Sao Paulo,300,4,5,5,acept,8800,2750,112,11662
Porto Alegre,47,1,1,1,not acept,2200,0,33,2233
Sao Paulo,35,1,1,0,acept,1300,39,17,1356
Rio de Janeiro,46,2,1,0,acept,1400,0,19,1419
Sao Paulo,60,2,1,0,acept,2500,50,32,2582
Sao Paulo,170,3,2,3,acept,5000,0,76,5076
Rio de Janeiro,30,1,1,0,acept,1600,42,21,1663
Rio de Janeiro,84,2,2,1,not acept,2750,275,36,3061
Sao Paulo,720,4,5,4,acept,12000,3200,181,15381
Porto Alegre,83,2,1,0,acept,1300,31,19,1350
Sao Paulo,250,3,3,1,acept,6500,292,83,6875
Sao Paulo,325,3,5,0,acept,5800,2049,74,7923
Campinas,98,1,1,1,acept,2800,152,36,2988
Sao Paulo,95,2,2,1,acept,2400,180,37,2617
Sao Paulo,380,4,4,4,not acept,1500,1917,20,3437
Rio de Janeiro,70,2,1,0,acept,1600,240,21,1861
Sao Paulo,86,3,3,0,not acept,2500,75,32,2607
Belo Horizonte,367,4,3,8,acept,4500,404,74,4978
Sao Paulo,495,5,5,4,not acept,15000,2180,191,17371
Sao Paulo,320,4,4,6,acept,15000,3151,191,18342
Sao Paulo,197,3,4,3,acept,10000,0,127,10127
Sao Paulo,140,4,2,1,acept,2100,486,27,2613
Rio de Janeiro,105,2,1,1,acept,1960,46,26,2032
Sao Paulo,200,3,4,4,acept,2953,686,38,3677
Rio de Janeiro,88,3,2,1,acept,1960,1180,26,3166
Sao Paulo,96,3,3,2,acept,3700,486,47,4233
Sao Paulo,192,3,4,4,not acept,8500,0,108,8608
Sao Paulo,110,3,4,3,acept,3800,467,49,4316
Porto Alegre,43,1,1,2,acept,2500,75,37,2612
Sao Paulo,48,2,1,1,acept,1650,51,21,1722
Sao Paulo,65,2,1,0,not acept,1300,34,20,1354
Sao Paulo,400,5,3,6,acept,13950,1880,210,16040
Campinas,160,3,2,0,acept,1600,117,25,1742
Campinas,60,2,1,1,acept,1000,0,13,1013
Sao Paulo,110,3,2,2,acept,2200,490,28,2718
Belo Horizonte,56,3,1,1,not acept,1000,61,14,1075
Rio de Janeiro,140,3,2,2,acept,7500,417,97,8014
Sao Paulo,150,3,2,3,not acept,2500,0,38,2538
Sao Paulo,208,3,4,3,acept,3800,1100,49,4949
Belo Horizonte,32,1,1,0,not acept,1250,0,17,1267
Campinas,50,1,1,1,acept,500,105,7,612
Belo Horizonte,300,5,3,4,acept,6000,0,99,6099
Sao Paulo,32,1,1,1,acept,3250,0,42,3292
Porto Alegre,900,5,5,2,acept,1000,542,15,1557
Sao Paulo,40,1,1,0,not acept,850,0,11,861
Porto Alegre,301,3,3,4,acept,5860,34,105,5999
Sao Paulo,299,5,4,2,acept,5600,691,85,6376
Sao Paulo,131,3,2,1,acept,2400,184,31,2615
Rio de Janeiro,78,2,1,1,acept,1000,71,13,1084
Sao Paulo,45,1,1,0,not acept,928,57,14,999
Sao Paulo,250,5,3,2,acept,2960,232,45,3237
Porto Alegre,40,1,1,0,acept,650,9,10,669
Porto Alegre,40,1,1,1,acept,2200,50,33,2283
Sao Paulo,244,3,6,4,acept,15000,1527,191,16718
Belo Horizonte,190,2,3,0,acept,2500,14,41,2555
Porto Alegre,80,3,2,1,acept,1800,0,27,1827
Sao Paulo,56,1,1,1,acept,4600,467,59,5126
Rio de Janeiro,53,1,1,0,acept,1100,14,14,1128
Belo Horizonte,243,4,4,4,not acept,10000,1250,134,11384
Campinas,62,2,1,0,not acept,1268,0,20,1288
Porto Alegre,110,2,2,1,acept,1450,125,22,1597
Sao Paulo,176,3,3,3,acept,5000,542,64,5606
Sao Paulo,150,3,2,1,acept,4500,110,68,4678
Sao Paulo,190,4,4,3,acept,7000,860,89,7949
Rio de Janeiro,62,2,1,0,acept,2383,97,31,2511
Sao Paulo,78,2,1,0,acept,1520,0,20,1540
Sao Paulo,330,3,6,5,acept,7100,0,107,7207
Rio de Janeiro,284,4,4,1,acept,7950,692,103,8745
Belo Horizonte,999,6,6,6,acept,10800,1500,178,12478
Campinas,55,1,1,0,acept,1100,60,14,1174
Sao Paulo,50,2,1,1,acept,1520,40,20,1580
Porto Alegre,109,4,3,1,acept,1950,117,29,2096
Sao Paulo,420,4,4,2,acept,13000,1417,165,14582
Porto Alegre,40,1,1,0,acept,500,0,8,508
Sao Paulo,140,3,3,2,acept,2800,292,36,3128
Belo Horizonte,400,4,5,3,acept,8695,834,116,9645
Sao Paulo,28,1,1,1,not acept,3076,80,39,3195
Sao Paulo,74,2,2,0,acept,1650,0,21,1671
Belo Horizonte,41,2,1,1,acept,1100,79,15,1194
Sao Paulo,76,2,1,0,acept,2290,0,30,2320
Belo Horizonte,233,3,3,0,acept,1600,96,22,1718
Sao Paulo,30,1,1,0,not acept,1250,30,16,1296
Sao Paulo,530,4,5,6,acept,5950,1200,90,7240
Campinas,94,3,3,2,acept,2200,192,28,2420
Sao Paulo,160,3,3,1,acept,4500,84,58,4642
Rio de Janeiro,84,3,3,1,acept,3860,229,50,4139
Sao Paulo,120,3,2,2,acept,4610,400,59,5069
Sao Paulo,180,3,2,2,acept,4000,413,51,4464
Sao Paulo,51,2,1,1,acept,3700,5,47,3752
Porto Alegre,65,1,1,0,acept,1250,25,19,1294
Campinas,206,3,2,3,acept,3910,417,50,4377
Porto Alegre,75,3,2,1,acept,1740,110,26,1876
Porto Alegre,125,3,2,4,acept,6500,195,95,6790
Campinas,75,3,2,2,acept,1600,162,21,1783
Sao Paulo,96,3,1,1,acept,3550,140,45,3735
Belo Horizonte,80,2,2,1,acept,1500,109,20,1629
Porto Alegre,45,2,1,1,acept,1100,22,17,1139
Campinas,68,2,1,1,acept,1310,60,17,1387
Porto Alegre,50,2,1,1,acept,2750,72,41,2863
Sao Paulo,200,2,4,1,acept,15000,829,226,16055
Sao Paulo,100,3,2,2,acept,7950,313,101,8364
Sao Paulo,107,2,1,0,acept,4950,55,63,5068
Rio de Janeiro,60,1,2,0,acept,2244,50,29,2323
Rio de Janeiro,180,6,3,2,acept,3800,350,58,4208
Sao Paulo,85,3,2,2,acept,2500,75,38,2613
Sao Paulo,20,1,1,0,not acept,3142,67,40,3249
Belo Horizonte,260,4,3,2,acept,9700,611,160,10471
Belo Horizonte,152,4,4,3,acept,4100,525,55,4680
Rio de Janeiro,25,1,1,0,not acept,1336,63,18,1417
Sao Paulo,80,2,1,1,acept,1900,567,29,2496
Porto Alegre,79,2,2,1,acept,3200,0,27,3227
Sao Paulo,70,2,2,1,not acept,3440,250,44,3734
Sao Paulo,92,2,2,1,not acept,2490,158,32,2680
Porto Alegre,68,2,1,0,acept,1650,73,25,1748
Sao Paulo,158,3,3,2,not acept,5500,529,70,6099
Sao Paulo,45,1,1,1,not acept,3300,166,42,3508
Belo Horizonte,284,5,2,3,acept,4500,270,74,4844
Sao Paulo,500,4,6,3,acept,15000,845,226,16071
Sao Paulo,151,4,3,3,acept,4000,736,51,4787
Porto Alegre,65,2,1,1,acept,1066,15,16,1097
Sao Paulo,70,2,1,0,acept,2000,42,26,2068
Sao Paulo,115,4,3,4,acept,7000,0,89,7089
Sao Paulo,155,1,1,2,not acept,5500,0,70,5570
Sao Paulo,35,3,2,0,acept,1600,84,25,1709
Belo Horizonte,71,3,2,1,acept,1150,85,16,1251
Sao Paulo,48,2,1,1,acept,1865,17,24,1906
Porto Alegre,202,3,3,3,acept,7900,417,116,8433
Porto Alegre,18,1,1,0,acept,830,10,13,853
Campinas,76,3,1,1,not acept,1100,63,14,1177
Sao Paulo,25,1,1,0,not acept,2070,80,27,2177
Rio de Janeiro,68,2,1,1,not acept,2800,101,37,2938
Belo Horizonte,44,2,1,1,acept,1000,60,14,1074
Rio de Janeiro,320,3,3,2,acept,4800,820,62,5682
Sao Paulo,180,3,2,1,acept,4000,218,51,4269
Sao Paulo,250,3,2,2,acept,6000,0,91,6091
Porto Alegre,60,1,2,2,acept,3000,167,44,3211
Porto Alegre,180,3,2,2,acept,5048,0,90,5138
Sao Paulo,60,1,2,1,not acept,3300,500,42,3842
Porto Alegre,50,2,1,1,acept,1290,30,17,1337
Sao Paulo,35,1,1,0,acept,1100,30,14,1144
Sao Paulo,270,4,4,0,not acept,14000,1917,178,16095
Sao Paulo,479,4,5,4,acept,9500,525,143,10168
Sao Paulo,50,1,2,1,acept,5400,259,69,5728
Rio de Janeiro,80,2,2,1,acept,3000,118,39,3157
Porto Alegre,110,3,2,0,acept,1980,234,29,2243
Belo Horizonte,310,4,4,3,not acept,3000,341,40,3381
Campinas,500,4,4,3,not acept,15000,82,191,15273
Sao Paulo,256,3,3,2,not acept,5600,2417,85,8102
Sao Paulo,52,2,1,1,acept,1300,63,17,1380
Porto Alegre,44,1,1,1,acept,1200,0,18,1218
Sao Paulo,100,2,4,2,not acept,3000,330,39,3369
Belo Horizonte,500,5,4,4,acept,7000,485,115,7600
Sao Paulo,50,1,1,1,acept,2180,200,28,2408
Belo Horizonte,402,4,7,4,not acept,15000,158,200,15358
Campinas,45,1,1,1,not acept,3900,105,50,4055
Rio de Janeiro,40,1,1,0,acept,830,60,11,901
Sao Paulo,35,1,1,0,not acept,1270,17,17,1304
Rio de Janeiro,75,2,2,1,acept,2500,179,33,2712
Sao Paulo,190,3,4,4,acept,11000,1584,140,12724
Belo Horizonte,193,4,2,1,acept,1800,317,24,2141
Sao Paulo,90,3,2,2,not acept,2180,210,28,2418
Sao Paulo,215,3,4,4,acept,3980,695,51,4726
Rio de Janeiro,65,2,2,0,not acept,1700,84,22,1806
Rio de Janeiro,93,2,2,0,not acept,3180,272,41,3493
Campinas,50,2,1,1,acept,1170,0,15,1185
Sao Paulo,170,3,2,0,not acept,5550,255,84,5889
Rio de Janeiro,380,4,3,2,acept,4000,750,52,4802
Sao Paulo,150,3,3,0,acept,2560,0,39,2599
Rio de Janeiro,45,1,1,0,acept,1820,90,24,1934
Belo Horizonte,80,3,1,1,acept,2800,138,46,2984
Sao Paulo,35,1,1,0,not acept,1200,0,16,1216
Sao Paulo,22,1,1,0,not acept,700,5,9,714
Sao Paulo,107,3,2,2,acept,3300,413,42,3755
Sao Paulo,125,2,2,1,acept,1570,55,24,1649
Porto Alegre,80,3,2,2,acept,2000,59,30,2089
Sao Paulo,24,1,1,0,acept,2150,84,28,2262
Sao Paulo,87,3,2,3,acept,1300,265,17,1582
Sao Paulo,400,7,7,0,acept,14000,1667,211,15878
Campinas,55,1,1,1,acept,1100,80,14,1194
Sao Paulo,48,2,1,1,acept,1700,0,22,1722
Sao Paulo,129,3,2,2,acept,2250,156,29,2435
Rio de Janeiro,200,3,3,0,acept,2370,167,31,2568
Porto Alegre,240,5,4,4,acept,4760,584,85,5429
Sao Paulo,140,3,2,3,acept,8000,167,102,8269
Rio de Janeiro,30,1,1,0,not acept,850,126,11,987
Porto Alegre,28,1,1,1,acept,930,125,14,1069
Sao Paulo,43,1,1,0,acept,1700,0,22,1722
Rio de Janeiro,184,4,2,3,acept,2550,417,33,3000
Sao Paulo,120,3,3,2,acept,4800,400,61,5261
Sao Paulo,170,3,3,2,acept,2750,100,42,2892
Sao Paulo,77,3,2,1,not acept,2050,55,26,2131
Porto Alegre,50,1,1,0,acept,1300,12,19,1331
Porto Alegre,42,1,1,0,acept,1500,0,22,1522
Sao Paulo,250,2,1,0,acept,1500,9,23,1532
Belo Horizonte,33,1,1,1,acept,1600,9,22,1631
Porto Alegre,106,3,3,2,acept,2250,133,33,2416
Sao Paulo,480,5,8,6,acept,13200,1230,199,14629
Sao Paulo,74,1,1,1,not acept,6290,203,80,6573
Sao Paulo,230,4,5,4,not acept,6000,1167,77,7244
Campinas,62,2,1,0,acept,1200,38,16,1254
Rio de Janeiro,103,4,3,0,acept,2150,97,28,2275
Campinas,90,3,2,0,acept,1590,180,24,1794
Rio de Janeiro,15,1,1,0,not acept,1670,0,22,1692
Sao Paulo,137,3,3,1,acept,5500,303,70,5873
Porto Alegre,50,1,1,0,acept,600,23,9,632
Sao Paulo,76,2,1,0,acept,1700,62,22,1784
Sao Paulo,168,4,3,3,acept,3500,768,45,4313
Sao Paulo,148,3,3,3,not acept,4348,542,31,4921
Belo Horizonte,220,4,3,3,acept,4600,547,62,5209
Sao Paulo,120,3,3,2,acept,2039,0,8,2047
Campinas,136,4,5,2,acept,3800,280,49,4129
Rio de Janeiro,50,1,1,1,acept,860,84,12,956
Porto Alegre,78,3,1,1,acept,1200,400,18,1618
Sao Paulo,42,1,1,1,not acept,2350,151,30,2531
Sao Paulo,45,1,1,0,not acept,1400,69,18,1487
Sao Paulo,170,5,4,4,acept,6000,350,91,6441
Belo Horizonte,310,5,2,1,not acept,3500,208,58,3766
Sao Paulo,170,6,5,1,acept,3468,0,53,3521
Sao Paulo,68,2,1,1,acept,1200,0,16,1216
Sao Paulo,380,4,5,5,acept,15000,1800,191,16991
Sao Paulo,62,2,1,1,acept,1590,40,21,1651
Sao Paulo,30,1,1,1,acept,1560,61,20,1641
Belo Horizonte,50,2,1,1,acept,800,0,11,811
Belo Horizonte,20,1,1,0,not acept,500,42,7,549
Sao Paulo,63,2,2,1,acept,1920,79,29,2028
Sao Paulo,60,1,1,0,acept,2000,0,31,2031
Sao Paulo,86,3,3,0,acept,3000,100,39,3139
Sao Paulo,100,3,2,1,acept,2900,0,37,2937
Sao Paulo,70,2,2,1,acept,2850,179,37,3066
Sao Paulo,42,1,1,1,not acept,3300,172,42,3514
Sao Paulo,90,3,2,0,acept,3000,1,39,3040
Sao Paulo,45,1,1,1,not acept,5520,0,70,5590
Porto Alegre,73,2,3,1,acept,1957,79,29,2065
Porto Alegre,209,3,3,2,acept,3500,542,52,4094
Sao Paulo,200,4,3,2,acept,2000,216,26,2242
Rio de Janeiro,94,2,2,2,acept,2700,92,35,2827
Porto Alegre,115,2,2,1,acept,1847,9,27,1883
Belo Horizonte,200,4,2,1,not acept,3000,327,40,3367
Porto Alegre,147,3,1,1,not acept,2666,100,39,2805
Sao Paulo,60,1,1,1,acept,2000,0,26,2026
Sao Paulo,200,3,3,6,acept,6000,500,91,6591
Rio de Janeiro,150,2,1,0,acept,1500,180,20,1700
Sao Paulo,135,2,3,2,acept,3300,67,50,3417
Sao Paulo,78,1,2,2,acept,2300,215,30,2545
Sao Paulo,124,3,3,2,acept,4000,92,61,4153
Porto Alegre,102,3,2,1,acept,3000,234,44,3278
Campinas,200,5,2,4,acept,3200,269,49,3518
Sao Paulo,150,3,2,3,not acept,3000,375,46,3421
Rio de Janeiro,40,1,2,0,acept,1780,209,23,2012
Sao Paulo,240,3,4,4,not acept,5000,1000,64,6064
Sao Paulo,102,3,3,0,acept,3500,434,45,3979
Sao Paulo,149,3,3,2,not acept,5400,0,69,5469
Sao Paulo,300,4,2,3,acept,7182,709,108,7999
Belo Horizonte,75,2,2,2,not acept,4200,384,56,4640
Sao Paulo,48,2,1,1,acept,1723,0,22,1745
Rio de Janeiro,58,2,1,0,not acept,1232,51,16,1299
Porto Alegre,59,2,1,0,acept,700,17,11,728
Rio de Janeiro,136,3,2,1,acept,3800,600,49,4449
Sao Paulo,35,1,1,1,acept,3200,149,41,3390
Sao Paulo,103,3,2,1,acept,4400,126,56,4582
Sao Paulo,129,3,2,3,acept,3400,811,44,4255
Sao Paulo,175,3,3,3,acept,3500,153,45,3698
Campinas,96,3,2,2,acept,3400,138,44,3582
Rio de Janeiro,60,2,1,0,acept,1900,51,25,1976
Sao Paulo,38,1,1,1,acept,1375,3,18,1396
Belo Horizonte,211,3,3,3,not acept,2500,264,34,2798
Sao Paulo,72,2,1,1,acept,1000,12,13,1025
Sao Paulo,440,1,2,4,acept,9800,584,148,10532
Sao Paulo,70,3,2,1,acept,2000,100,26,2126
Sao Paulo,70,1,1,4,acept,1300,42,20,1362
Sao Paulo,53,2,2,1,acept,1500,117,20,1637
Sao Paulo,161,2,2,3,acept,4800,1125,61,5986
Sao Paulo,180,3,3,1,acept,3100,300,22,3422
Porto Alegre,260,2,5,4,acept,4500,75,80,4655
Belo Horizonte,60,2,1,1,not acept,1150,50,19,1219
Sao Paulo,120,1,2,2,acept,9000,700,115,9815
Porto Alegre,36,1,1,0,not acept,630,24,10,664
Belo Horizonte,278,4,4,4,acept,12000,155,160,12315
Sao Paulo,113,2,2,1,acept,3000,50,39,3089
Sao Paulo,30,1,1,0,acept,3300,0,42,3342
Sao Paulo,300,4,3,3,acept,4000,283,61,4344
Campinas,48,2,1,1,acept,820,45,11,876
Sao Paulo,524,4,5,3,acept,11050,1167,167,12384
Sao Paulo,94,3,2,3,acept,2200,350,28,2578
Sao Paulo,320,4,6,4,acept,15000,175,191,15366
Sao Paulo,51,2,1,1,acept,2500,17,32,2549
Sao Paulo,78,2,2,1,acept,7250,390,92,7732
Rio de Janeiro,40,1,1,0,acept,1080,50,14,1144
Sao Paulo,360,4,4,3,not acept,8000,750,121,8871
Porto Alegre,47,1,1,1,not acept,2630,135,39,2804
Sao Paulo,45,2,1,1,acept,1650,29,21,1700
Belo Horizonte,30,1,1,0,acept,550,35,8,593
Rio de Janeiro,235,4,3,1,not acept,5950,500,77,6527
Sao Paulo,142,3,4,3,not acept,5440,400,69,5909
Sao Paulo,75,2,1,1,acept,3400,84,44,3528
Rio de Janeiro,117,3,1,1,not acept,3700,103,48,3851
Sao Paulo,280,3,3,5,acept,3500,2,53,3555
Sao Paulo,380,4,4,5,acept,10000,2584,127,12711
Sao Paulo,133,3,3,2,acept,14000,898,178,15076
Porto Alegre,83,2,2,1,acept,1400,67,21,1488
Sao Paulo,93,2,2,1,acept,3450,84,44,3578
Sao Paulo,178,3,2,3,acept,4250,167,54,4471
Sao Paulo,53,2,1,1,acept,1250,0,16,1266
Sao Paulo,165,3,3,3,acept,2700,767,35,3502
Sao Paulo,50,2,1,1,not acept,1900,0,25,1925
Sao Paulo,100,2,1,2,acept,3200,67,49,3316
Sao Paulo,70,2,2,1,acept,2400,67,37,2504
Sao Paulo,250,3,4,5,acept,4000,500,61,4561
Campinas,55,1,1,1,acept,700,36,9,745
Belo Horizonte,294,3,4,4,acept,3600,543,48,4191
Porto Alegre,56,2,1,1,acept,800,38,12,850
Sao Paulo,220,3,4,4,acept,8000,834,102,8936
Rio de Janeiro,44,1,1,0,acept,1000,57,13,1070
Belo Horizonte,15,1,1,0,not acept,1100,0,15,1115
Rio de Janeiro,80,2,2,1,acept,2200,67,29,2296
Sao Paulo,70,2,2,1,acept,2000,0,26,2026
Sao Paulo,368,4,6,6,acept,7500,2078,96,9674
Sao Paulo,35,1,1,0,acept,1660,0,22,1682
Sao Paulo,292,4,4,4,acept,5000,686,64,5750
Campinas,470,4,4,4,acept,11000,1080,140,12220
Porto Alegre,68,2,2,2,acept,1700,60,25,1785
Porto Alegre,83,2,2,2,acept,1900,70,28,1998
Belo Horizonte,70,2,2,1,not acept,4700,250,63,5013
Rio de Janeiro,300,3,4,2,acept,13000,1105,168,14273
Sao Paulo,62,1,1,0,acept,2792,38,36,2866
Sao Paulo,75,3,2,1,acept,2900,28,37,2965
Sao Paulo,75,3,1,1,acept,2470,0,38,2508
Sao Paulo,72,3,2,1,acept,1830,114,24,1968
Sao Paulo,160,3,3,4,acept,5000,92,64,5156
Sao Paulo,150,3,4,2,not acept,3400,0,52,3452
Sao Paulo,224,4,4,3,acept,9350,917,119,10386
Sao Paulo,540,4,3,5,acept,14000,3534,211,17745
Rio de Janeiro,50,2,1,1,acept,1600,13,21,1634
Rio de Janeiro,80,2,2,1,acept,1400,59,19,1478
Belo Horizonte,190,3,2,2,acept,4850,502,65,5417
Sao Paulo,160,3,2,2,acept,2900,400,37,3337
Porto Alegre,92,3,1,0,acept,1800,42,27,1869
Sao Paulo,30,1,1,0,acept,1550,21,20,1591
Belo Horizonte,268,4,4,3,acept,2700,250,45,2995
Sao Paulo,40,1,1,0,acept,1300,30,17,1347
Rio de Janeiro,186,3,1,0,acept,1500,364,20,1884
Sao Paulo,100,2,2,1,acept,4800,321,73,5194
Sao Paulo,120,3,4,2,not acept,4009,566,51,4626
Sao Paulo,160,2,3,2,acept,14000,413,178,14591
Sao Paulo,224,4,5,2,acept,3800,731,58,4589
Sao Paulo,33,2,1,0,acept,2000,0,26,2026
Sao Paulo,360,4,5,4,not acept,10000,917,151,11068
Porto Alegre,444,3,6,4,acept,4500,959,66,5525
Sao Paulo,93,3,2,2,acept,2200,84,28,2312
Sao Paulo,49,1,2,0,acept,1300,0,17,1317
Sao Paulo,90,1,1,1,acept,1300,67,17,1384
Porto Alegre,96,3,2,2,acept,3298,70,49,3417
Porto Alegre,98,2,2,0,not acept,1600,70,24,1694
Sao Paulo,240,3,4,3,acept,6000,325,91,6416
Belo Horizonte,45,2,1,1,acept,850,50,12,912
Campinas,50,2,1,1,acept,800,200,11,1011
Rio de Janeiro,160,3,2,1,acept,4500,529,58,5087
Porto Alegre,67,3,2,1,acept,1230,60,18,1308
Belo Horizonte,205,4,2,4,acept,3990,150,66,4206
Sao Paulo,25,1,1,0,not acept,600,0,10,610
Sao Paulo,167,3,3,3,acept,2800,542,36,3378
Campinas,50,1,1,1,acept,900,69,12,981
Sao Paulo,104,2,2,2,acept,4150,380,53,4583
Porto Alegre,40,1,1,1,acept,650,5,10,665
Belo Horizonte,135,4,2,1,acept,2200,138,30,2368
Sao Paulo,210,3,2,2,acept,2780,500,42,3322
Campinas,70,2,1,1,acept,1300,0,17,1317
Sao Paulo,200,3,3,1,acept,3200,167,41,3408
Sao Paulo,300,4,4,4,acept,2500,917,32,3449
Rio de Janeiro,155,4,3,1,not acept,8600,350,111,9061
Sao Paulo,281,4,4,8,acept,10000,847,151,10998
Sao Paulo,23,1,1,0,acept,2050,40,26,2116
Sao Paulo,80,1,1,1,acept,7200,0,92,7292
Porto Alegre,99,3,2,0,acept,1088,112,16,1216
Sao Paulo,239,3,3,3,acept,7000,177,106,7283
Sao Paulo,356,3,4,4,not acept,9000,709,136,9845
Sao Paulo,350,5,5,3,not acept,10580,630,135,11345
Sao Paulo,270,4,5,4,acept,12000,1720,153,13873
Sao Paulo,200,4,4,1,not acept,3800,834,49,4683
Sao Paulo,124,3,3,3,acept,3670,709,47,4426
Sao Paulo,202,3,4,3,acept,10250,834,130,11214
Sao Paulo,40,1,1,0,acept,3000,225,39,3264
Sao Paulo,230,2,2,3,acept,2550,845,33,3428
Porto Alegre,45,1,1,1,acept,595,21,9,625
Sao Paulo,23,1,1,1,acept,2300,59,30,2389
Sao Paulo,340,4,4,0,acept,4000,334,61,4395
Sao Paulo,342,5,6,5,not acept,6000,422,91,6513
Sao Paulo,93,2,2,2,acept,5500,325,70,5895
Sao Paulo,174,3,4,3,not acept,10400,817,132,11349
Rio de Janeiro,95,2,3,2,acept,2000,159,26,2185
Sao Paulo,104,2,2,2,not acept,3100,34,40,3174
Sao Paulo,65,1,1,1,not acept,2500,0,32,2532
Sao Paulo,90,1,1,0,acept,2200,109,34,2343
Rio de Janeiro,104,3,2,1,acept,2500,125,33,2658
Sao Paulo,78,2,2,2,acept,2700,0,35,2735
Sao Paulo,140,3,2,2,acept,3200,225,49,3474
Sao Paulo,50,2,2,1,acept,1900,0,25,1925
Sao Paulo,270,4,3,3,acept,10900,392,164,11456
Rio de Janeiro,131,2,1,0,acept,790,128,11,929
Porto Alegre,69,2,2,1,acept,1500,107,22,1629
Sao Paulo,630,4,6,4,not acept,12300,2667,185,15152
Sao Paulo,140,3,3,2,acept,5100,167,65,5332
Sao Paulo,255,3,4,4,acept,5000,125,64,5189
Sao Paulo,187,4,3,2,acept,5430,598,69,6097
Porto Alegre,120,3,2,1,acept,1020,25,15,1060
Porto Alegre,50,2,1,1,acept,1000,25,18,1043
Sao Paulo,190,3,3,1,acept,6300,459,80,6839
Sao Paulo,16,1,1,0,not acept,980,0,13,993
Sao Paulo,92,2,1,1,not acept,6860,0,87,6947
Sao Paulo,56,3,1,0,acept,1900,30,25,1955
Belo Horizonte,58,1,2,2,acept,1400,100,19,1519
Sao Paulo,45,2,1,1,acept,1620,59,21,1700
Rio de Janeiro,70,2,2,1,acept,850,0,11,861
Belo Horizonte,125,3,3,1,acept,2100,218,28,2346
Sao Paulo,79,3,2,0,acept,1250,78,16,1344
Campinas,62,2,2,2,acept,1900,82,25,2007
Campinas,55,1,1,0,acept,1200,50,16,1266
Sao Paulo,84,2,2,0,acept,1500,0,20,1520
Campinas,58,2,2,2,acept,2200,100,28,2328
Sao Paulo,80,2,1,0,not acept,1400,100,22,1522
Sao Paulo,196,4,4,5,acept,12500,1667,159,14326
Sao Paulo,326,3,4,4,acept,6500,1605,83,8188
Belo Horizonte,54,2,1,2,acept,900,120,12,1032
Porto Alegre,62,1,1,0,acept,900,13,14,927
Sao Paulo,72,2,1,1,not acept,1350,100,18,1468
Sao Paulo,156,3,2,2,acept,7500,385,96,7981
Sao Paulo,250,3,2,8,acept,6500,1360,98,7958
Sao Paulo,45,1,1,1,acept,2450,158,32,2640
Sao Paulo,200,4,4,3,acept,5000,0,64,5064
Belo Horizonte,131,3,2,3,acept,2750,351,37,3138
Sao Paulo,55,1,1,1,not acept,2860,184,37,3081
Sao Paulo,118,3,2,2,acept,8500,434,108,9042
Sao Paulo,300,3,4,1,acept,4500,542,68,5110
Sao Paulo,45,1,1,1,acept,2500,15,32,2547
Belo Horizonte,372,3,4,3,acept,5500,343,91,5934
Sao Paulo,55,1,1,1,not acept,1600,0,21,1621
Campinas,55,2,1,1,acept,1397,80,18,1495
Sao Paulo,46,2,1,0,not acept,1230,34,16,1280
Sao Paulo,24,1,1,1,not acept,1310,0,20,1330
Sao Paulo,52,2,1,1,acept,1450,0,19,1469
Sao Paulo,180,4,3,2,acept,5500,667,70,6237
Sao Paulo,97,3,2,2,acept,1950,325,25,2300
Sao Paulo,200,3,2,4,acept,3500,0,53,3553
Sao Paulo,67,2,2,2,acept,5000,224,64,5288
Porto Alegre,101,2,1,2,acept,1600,300,24,1924
Belo Horizonte,240,4,4,3,acept,4600,0,62,4662
Sao Paulo,250,6,2,2,acept,2472,26,38,2536
Campinas,94,3,1,0,acept,1000,90,13,1103
Sao Paulo,50,1,1,0,acept,2000,73,26,2099
Porto Alegre,74,2,2,2,acept,2500,0,37,2537
Campinas,105,2,1,1,acept,1400,77,18,1495
Porto Alegre,38,1,1,0,not acept,1600,34,24,1658
Sao Paulo,50,2,1,1,acept,1150,0,15,1165
Sao Paulo,54,1,1,1,acept,2538,0,18,2556
Rio de Janeiro,38,1,1,0,acept,1290,90,17,1397
Campinas,115,3,2,2,acept,1948,109,25,2082
Belo Horizonte,70,2,1,1,acept,1100,66,15,1181
Rio de Janeiro,102,3,4,3,acept,5800,459,75,6334
Porto Alegre,42,2,1,0,acept,790,23,12,825
Sao Paulo,70,2,2,1,not acept,1000,138,13,1151
Sao Paulo,52,2,1,0,acept,1200,65,16,1281
Sao Paulo,800,4,5,8,acept,12000,2334,181,14515
Sao Paulo,40,1,1,1,acept,1780,0,23,1803
Sao Paulo,74,3,2,1,acept,3000,0,39,3039
Campinas,110,2,2,0,acept,4200,218,54,4472
Campinas,56,1,1,1,acept,800,40,11,851
Porto Alegre,46,1,1,1,acept,1300,15,19,1334
Sao Paulo,125,3,3,1,acept,2000,25,26,2051
Belo Horizonte,224,4,4,4,acept,8500,1199,114,9813
Sao Paulo,58,1,2,1,not acept,4800,130,61,4991
Sao Paulo,400,6,6,8,acept,4335,1750,55,6140
Sao Paulo,58,1,1,1,acept,1600,89,21,1710
Sao Paulo,52,1,1,0,acept,3300,0,42,3342
Porto Alegre,82,3,1,2,acept,800,30,12,842
Belo Horizonte,180,4,3,4,acept,4550,409,61,5020
Sao Paulo,58,2,2,1,acept,1383,94,16,1493
Belo Horizonte,600,5,3,6,acept,15000,1667,246,16913
Porto Alegre,59,2,2,1,not acept,1250,56,19,1325
Sao Paulo,280,3,5,2,acept,7000,625,106,7731
Porto Alegre,275,5,2,4,acept,3200,250,57,3507
Porto Alegre,58,2,1,2,acept,2100,45,31,2176
Sao Paulo,170,3,2,2,acept,9000,900,115,10015
Sao Paulo,16,1,1,0,not acept,850,9,11,870
Rio de Janeiro,192,3,2,1,acept,4500,350,69,4919
Sao Paulo,196,2,3,3,acept,5500,73,70,5643
Sao Paulo,45,1,1,1,not acept,4000,84,51,4135
Sao Paulo,40,1,1,0,acept,1100,0,14,1114
Sao Paulo,289,3,3,2,not acept,15000,777,191,15968
Campinas,73,3,2,2,not acept,1500,204,20,1724
Sao Paulo,65,3,1,1,acept,1900,20,25,1945
Sao Paulo,25,1,1,0,not acept,1178,27,15,1220
Sao Paulo,68,1,1,1,acept,6000,584,77,6661
Sao Paulo,512,4,6,5,acept,3500,2817,45,6362
Sao Paulo,100,3,3,2,acept,3310,379,42,3731
Sao Paulo,41,1,1,1,acept,2800,133,36,2969
Rio de Janeiro,80,3,2,0,acept,2720,192,36,2948
Sao Paulo,53,1,1,0,not acept,1680,68,22,1770
Belo Horizonte,52,2,1,1,acept,1375,66,19,1460
Belo Horizonte,130,3,2,2,acept,2200,260,30,2490
Sao Paulo,87,3,2,0,not acept,3500,0,45,3545
Campinas,55,2,1,1,acept,950,20,13,983
Porto Alegre,68,1,1,1,not acept,1300,70,19,1389
Sao Paulo,230,3,4,4,not acept,6500,750,83,7333
Porto Alegre,75,3,2,1,acept,1510,90,23,1623
Sao Paulo,50,2,1,0,not acept,1000,45,13,1058
Sao Paulo,465,4,4,4,acept,6500,1167,83,7750
Campinas,346,5,5,2,acept,3800,407,58,4265
Campinas,113,3,3,2,acept,3804,0,49,3853
Rio de Janeiro,75,1,2,1,acept,4300,209,56,4565
Sao Paulo,125,3,3,2,acept,3250,500,42,3792
Sao Paulo,35,1,1,0,not acept,1230,0,16,1246
Sao Paulo,34,1,1,0,acept,4600,55,59,4714
Sao Paulo,200,5,2,3,acept,4800,300,73,5173
Sao Paulo,215,4,4,3,acept,3400,1084,44,4528
Sao Paulo,92,3,2,2,acept,3100,253,40,3393
Belo Horizonte,70,3,2,1,acept,1250,86,17,1353
Sao Paulo,61,2,1,0,not acept,1220,25,16,1261
Sao Paulo,37,1,1,0,acept,1100,37,14,1151
Rio de Janeiro,30,1,1,0,acept,2600,21,19,2640
Belo Horizonte,65,3,1,1,acept,850,59,12,921
Porto Alegre,40,1,1,0,acept,1630,4,24,1658
Porto Alegre,52,2,1,1,not acept,750,18,11,779
Sao Paulo,39,1,1,1,acept,2200,60,28,2288
Sao Paulo,350,3,3,8,acept,9240,1042,139,10421
Rio de Janeiro,70,2,1,0,not acept,2900,200,38,3138
Campinas,140,3,3,2,acept,2330,198,30,2558
Sao Paulo,70,2,1,0,acept,999,42,16,1057
Belo Horizonte,60,1,2,1,acept,2200,0,30,2230
Sao Paulo,100,3,1,0,acept,3900,120,50,4070
Porto Alegre,53,2,1,0,acept,1560,0,23,1583
Sao Paulo,170,2,3,3,not acept,5950,417,76,6443
Porto Alegre,270,3,2,2,acept,2350,213,42,2605
Sao Paulo,68,2,2,1,acept,4900,167,63,5130
Sao Paulo,58,2,2,2,acept,1450,70,19,1539
Campinas,73,3,2,1,acept,1600,100,21,1721
Sao Paulo,20,1,1,0,acept,1800,130,23,1953
Porto Alegre,60,2,1,1,acept,950,0,14,964
Sao Paulo,65,3,2,0,acept,3200,245,41,3486
Belo Horizonte,32,1,1,0,not acept,1300,0,18,1318
Rio de Janeiro,80,2,2,0,acept,1700,100,22,1822
Porto Alegre,50,1,1,0,acept,650,80,10,740
Sao Paulo,65,2,2,1,acept,2800,209,36,3045
Porto Alegre,129,2,2,2,acept,6800,209,100,7109
Sao Paulo,145,2,2,1,acept,4300,72,55,4427
Campinas,48,1,1,1,not acept,736,0,10,746
Sao Paulo,38,1,1,1,acept,2000,100,26,2126
Belo Horizonte,520,5,5,2,not acept,15000,780,200,15980
Belo Horizonte,184,3,3,1,acept,1200,132,16,1348
Sao Paulo,130,2,3,2,not acept,4000,417,51,4468
Rio de Janeiro,26,1,1,0,acept,1500,58,20,1578
Sao Paulo,350,7,4,2,not acept,8000,1250,121,9371
Porto Alegre,38,1,1,0,acept,1300,38,19,1357
Porto Alegre,194,2,3,0,acept,3310,333,49,3692
Sao Paulo,160,3,3,2,acept,12650,360,161,13171
Belo Horizonte,32,1,1,1,acept,1500,132,20,1652
Rio de Janeiro,175,4,1,0,acept,2146,197,33,2376
Sao Paulo,26,1,1,1,acept,1700,223,22,1945
Campinas,66,2,1,1,acept,1050,47,14,1111
Sao Paulo,83,3,2,1,not acept,3300,80,42,3422
Sao Paulo,50,1,1,0,acept,2800,0,36,2836
Sao Paulo,400,3,6,3,acept,4780,817,72,5669
Sao Paulo,30,1,1,1,acept,3300,9,42,3351
Sao Paulo,92,3,2,1,acept,2000,195,26,2221
Belo Horizonte,156,7,2,1,acept,2200,187,30,2417
Sao Paulo,150,3,4,3,acept,1980,648,26,2654
Rio de Janeiro,25,1,1,0,acept,550,0,8,558
Rio de Janeiro,60,2,1,1,acept,1450,236,19,1705
Sao Paulo,40,1,1,1,not acept,2300,34,30,2364
Sao Paulo,180,4,4,2,acept,2000,584,26,2610
Sao Paulo,230,3,2,3,not acept,4500,367,68,4935
Sao Paulo,70,2,2,0,acept,1850,50,24,1924
Sao Paulo,70,1,2,1,acept,1500,125,23,1648
Sao Paulo,380,4,4,2,acept,5500,1000,83,6583
Porto Alegre,80,2,2,2,acept,3670,163,54,3887
Campinas,66,2,2,1,not acept,2270,76,29,2375
Sao Paulo,86,2,1,1,acept,2500,0,32,2532
Porto Alegre,80,3,2,1,acept,1739,25,26,1790
Porto Alegre,84,3,2,1,acept,1600,109,24,1733
Sao Paulo,262,3,5,3,acept,5525,1000,71,6596
Belo Horizonte,90,3,1,1,acept,1430,99,20,1549
Belo Horizonte,160,3,3,3,not acept,4500,350,74,4924
Sao Paulo,58,2,2,1,acept,2100,88,27,2215
Sao Paulo,165,3,3,2,acept,6000,502,77,6579
Sao Paulo,48,1,1,0,acept,1490,0,19,1509
Sao Paulo,112,3,2,3,acept,3300,32,50,3382
Sao Paulo,110,3,2,2,acept,3500,205,45,3750
Belo Horizonte,72,2,2,2,acept,5300,375,71,5746
Rio de Janeiro,65,1,1,0,acept,1800,30,24,1854
Belo Horizonte,150,3,1,1,acept,780,0,11,791
Sao Paulo,65,3,2,1,not acept,1900,29,25,1954
Porto Alegre,90,3,1,1,acept,1550,0,23,1573
Porto Alegre,66,2,2,0,acept,1600,0,24,1624
Sao Paulo,117,2,3,3,acept,9000,560,115,9675
Rio de Janeiro,80,3,2,0,not acept,2870,180,37,3087
Rio de Janeiro,64,2,1,0,acept,900,38,12,950
Sao Paulo,64,1,1,0,acept,1750,0,23,1773
Sao Paulo,55,1,1,0,acept,1650,0,25,1675
Porto Alegre,70,2,1,1,acept,1350,28,20,1398
Sao Paulo,74,2,3,2,acept,3200,40,41,3281
Sao Paulo,126,3,4,1,acept,4000,309,51,4360
Sao Paulo,480,4,5,3,acept,15000,742,226,15968
Belo Horizonte,97,3,3,1,not acept,1300,109,18,1427
Porto Alegre,76,2,2,1,acept,2200,70,33,2303
Rio de Janeiro,102,3,1,1,acept,1500,137,20,1657
Belo Horizonte,200,4,3,2,acept,5700,236,94,6030
Sao Paulo,38,1,1,0,acept,1900,5,25,1930
Sao Paulo,400,4,5,3,acept,6000,1195,77,7272
Sao Paulo,200,3,1,2,acept,3000,0,46,3046
Belo Horizonte,80,3,2,0,not acept,1500,112,20,1632
Campinas,80,3,1,4,acept,5500,0,83,5583
Belo Horizonte,200,4,3,2,acept,14500,403,238,15141
Sao Paulo,36,1,1,0,not acept,1650,0,21,1671
Sao Paulo,151,3,3,3,acept,3950,750,51,4751
Sao Paulo,49,2,2,1,acept,2400,55,31,2486
Sao Paulo,51,1,1,0,acept,1700,84,22,1806
Porto Alegre,80,3,2,1,not acept,2700,84,40,2824
Campinas,55,2,1,1,acept,870,90,12,972
Sao Paulo,110,2,2,1,acept,2700,121,35,2856
Belo Horizonte,30,1,1,1,not acept,860,0,12,872
Campinas,60,2,1,1,acept,1100,84,14,1198
Sao Paulo,830,2,2,2,acept,2001,159,31,2191
Sao Paulo,140,3,2,2,not acept,5000,142,64,5206
Belo Horizonte,70,3,1,1,not acept,1150,0,16,1166
Sao Paulo,140,3,2,0,acept,7000,542,89,7631
Rio de Janeiro,90,2,2,0,not acept,6000,70,78,6148
Rio de Janeiro,85,3,2,1,acept,2300,115,30,2445
Rio de Janeiro,150,3,3,1,not acept,4000,334,52,4386
Rio de Janeiro,70,2,1,0,not acept,950,30,13,993
Sao Paulo,205,3,3,4,acept,8500,788,108,9396
Belo Horizonte,167,4,3,3,not acept,5140,167,69,5376
Porto Alegre,47,1,1,1,not acept,2200,0,33,2233
Porto Alegre,63,2,2,1,acept,2000,56,30,2086
Rio de Janeiro,18,1,1,0,not acept,1040,95,14,1149
Rio de Janeiro,187,2,3,3,acept,3100,292,40,3432
Sao Paulo,79,3,2,2,acept,2200,146,28,2374
Porto Alegre,44,1,1,0,acept,769,35,12,816
Sao Paulo,90,2,3,1,acept,2100,0,27,2127
Sao Paulo,220,4,2,1,not acept,6000,17,77,6094
Campinas,100,2,1,0,acept,900,61,12,973
Sao Paulo,120,3,4,3,acept,4440,289,57,4786
Belo Horizonte,180,4,3,3,acept,4500,520,60,5080
Rio de Janeiro,253,4,3,1,acept,3000,600,39,3639
Sao Paulo,50,2,1,0,not acept,900,50,14,964
Belo Horizonte,120,2,3,1,acept,1800,0,24,1824
Sao Paulo,220,4,2,2,not acept,8000,650,102,8752
Sao Paulo,140,2,1,0,acept,2200,0,28,2228
Rio de Janeiro,180,4,2,2,not acept,7500,409,97,8006
Sao Paulo,170,3,5,3,not acept,4500,951,19,5470
Sao Paulo,250,5,3,6,acept,15000,2704,226,17930
Rio de Janeiro,70,1,2,1,acept,2200,149,29,2378
Rio de Janeiro,60,1,1,0,acept,1000,0,13,1013
Sao Paulo,380,4,2,6,acept,9800,525,148,10473
Sao Paulo,32,1,1,1,not acept,2150,0,28,2178
Porto Alegre,116,3,2,2,acept,3400,200,50,3650
Rio de Janeiro,19,1,1,0,acept,500,45,7,552
Campinas,140,3,2,1,acept,2000,221,26,2247
Sao Paulo,500,4,3,5,not acept,12000,84,181,12265
Porto Alegre,80,2,1,0,acept,950,0,17,967
Rio de Janeiro,64,2,1,0,not acept,1700,78,26,1804
Sao Paulo,20,1,1,0,acept,2060,0,27,2087
Sao Paulo,237,4,4,4,acept,4990,1031,64,6085
Sao Paulo,190,4,4,3,acept,6000,899,77,6976
Rio de Janeiro,28,1,1,0,acept,1600,0,21,1621
Campinas,46,2,1,1,not acept,1100,53,5,1158
Porto Alegre,120,3,2,2,not acept,2000,121,30,2151
Sao Paulo,76,2,1,1,acept,2000,45,31,2076
Sao Paulo,142,3,2,1,acept,8500,194,108,8802
Rio de Janeiro,296,3,2,1,acept,13500,848,174,14522
Belo Horizonte,365,4,6,6,acept,13000,459,214,13673
Rio de Janeiro,125,4,2,2,not acept,4500,40,58,4598
Campinas,55,2,1,1,acept,1550,83,20,1653
Sao Paulo,400,6,4,3,acept,3999,2250,61,6310
Sao Paulo,50,1,1,0,acept,1190,114,18,1322
Sao Paulo,36,1,1,0,acept,2680,47,34,2761
Porto Alegre,48,1,1,1,acept,2500,0,37,2537
Porto Alegre,38,1,1,0,acept,850,34,13,897
Porto Alegre,94,1,1,1,acept,4800,250,71,5121
Sao Paulo,49,2,1,1,not acept,1890,0,24,1914
Rio de Janeiro,60,2,1,1,acept,1300,53,17,1370
Campinas,70,2,3,1,acept,2004,0,26,2030
Sao Paulo,75,3,2,1,acept,1539,0,20,1559
Sao Paulo,54,1,1,0,acept,3949,0,51,4000
Sao Paulo,50,1,1,0,acept,3398,177,44,3619
Rio de Janeiro,81,2,3,2,not acept,5500,1800,71,7371
Sao Paulo,750,4,6,2,acept,15000,2041,226,17267
Sao Paulo,20,1,1,0,acept,1800,130,23,1953
Sao Paulo,100,2,3,2,acept,12960,0,165,13125
Sao Paulo,49,1,1,1,not acept,1200,0,16,1216
Sao Paulo,20,1,1,0,not acept,1000,84,13,1097
Rio de Janeiro,80,2,1,0,acept,600,94,8,702
Rio de Janeiro,156,3,2,3,acept,2200,167,29,2396
Sao Paulo,287,3,3,4,acept,4477,900,68,5445
Belo Horizonte,130,4,4,3,not acept,5200,529,70,5799
Porto Alegre,302,4,4,3,acept,8973,750,132,9855
Sao Paulo,35,1,1,0,not acept,1740,50,23,1813
Sao Paulo,90,2,1,0,acept,1990,0,26,2016
Sao Paulo,81,2,1,1,not acept,3910,340,50,4300
Rio de Janeiro,40,2,1,0,acept,1417,84,18,1519
Sao Paulo,60,2,1,1,acept,1841,77,7,1925
Rio de Janeiro,25,1,1,0,not acept,2928,34,38,3000
Sao Paulo,700,5,7,5,acept,15000,2240,226,17466
Sao Paulo,237,3,5,3,acept,5500,917,70,6487
Sao Paulo,162,2,2,1,acept,5000,545,64,5609
Sao Paulo,190,4,3,2,not acept,8311,415,125,8851
Campinas,46,1,1,0,acept,1950,0,25,1975
Sao Paulo,172,3,4,3,acept,8000,820,102,8922
Sao Paulo,236,4,5,5,acept,5000,1261,64,6325
Sao Paulo,100,3,1,2,not acept,1600,84,25,1709
Belo Horizonte,80,1,1,0,acept,1000,0,14,1014
Sao Paulo,335,3,4,4,acept,6200,650,94,6944
Sao Paulo,190,3,2,1,acept,4100,84,62,4246
Rio de Janeiro,207,4,3,1,acept,4240,542,55,4837
Porto Alegre,72,2,2,1,acept,2000,109,30,2139
Porto Alegre,102,3,2,1,acept,4000,125,59,4184
Sao Paulo,50,1,1,0,not acept,880,17,14,911
Sao Paulo,150,3,4,0,acept,5900,475,75,6450
Belo Horizonte,220,4,3,2,acept,3500,271,47,3818
Sao Paulo,150,3,3,1,acept,13000,305,165,13470
Rio de Janeiro,110,3,2,1,acept,2100,155,28,2283
Sao Paulo,300,4,4,4,acept,9000,1667,115,10782
Porto Alegre,29,1,1,0,acept,1380,15,21,1416
Sao Paulo,40,1,1,0,acept,2300,0,30,2330
Sao Paulo,500,4,5,3,not acept,13500,3334,172,17006
Sao Paulo,45,1,1,1,acept,2300,0,30,2330
Rio de Janeiro,75,2,2,1,acept,1800,84,24,1908
Sao Paulo,80,2,2,1,acept,3200,213,41,3454
Porto Alegre,65,2,1,0,acept,850,34,13,897
Sao Paulo,400,5,5,4,acept,6141,817,93,7051
Sao Paulo,49,1,1,2,acept,8000,217,102,8319
Sao Paulo,70,2,1,0,acept,2100,114,27,2241
Sao Paulo,130,4,2,6,acept,6100,512,92,6704
Sao Paulo,146,3,4,3,acept,6000,584,77,6661
Porto Alegre,64,2,1,0,acept,2000,57,30,2087
Sao Paulo,63,3,2,1,acept,3300,10,42,3352
Belo Horizonte,46,2,1,1,acept,850,62,12,924
Sao Paulo,90,2,1,0,acept,1199,42,19,1260
Sao Paulo,573,4,5,7,acept,14000,1974,211,16185
Sao Paulo,38,1,1,0,acept,1680,0,22,1702
Belo Horizonte,70,2,1,1,acept,1500,125,20,1645
Belo Horizonte,23,1,1,0,not acept,950,50,13,1013
Sao Paulo,84,2,2,1,acept,2000,109,31,2140
Rio de Janeiro,40,1,1,1,not acept,2500,128,33,2661
Sao Paulo,1600,4,5,12,acept,6900,5000,104,12004
Belo Horizonte,200,5,3,2,acept,2300,170,38,2508
Sao Paulo,100,3,2,0,acept,3000,172,46,3218
Porto Alegre,69,2,2,0,acept,1500,40,22,1562
Sao Paulo,92,3,2,2,acept,2800,179,36,3015
Sao Paulo,120,3,2,4,acept,4500,398,58,4956
Belo Horizonte,90,3,2,2,not acept,2500,348,34,2882
Sao Paulo,53,2,1,1,acept,3250,67,42,3359
Sao Paulo,300,3,3,4,acept,3700,950,56,4706
Sao Paulo,65,2,2,2,acept,3200,234,41,3475
Belo Horizonte,269,4,3,2,acept,4900,357,81,5338
Campinas,130,3,2,1,acept,2500,100,32,2632
Sao Paulo,248,3,4,4,acept,5500,146,70,5716
Belo Horizonte,45,1,1,1,not acept,1300,101,18,1419
Sao Paulo,130,3,1,2,acept,3800,130,58,3988
Porto Alegre,75,2,1,0,acept,1100,60,17,1177
Rio de Janeiro,250,2,4,8,acept,4500,325,69,4894
Sao Paulo,35,1,1,1,acept,2370,0,31,2401
Rio de Janeiro,130,3,3,1,acept,2700,260,35,2995
Sao Paulo,30,1,1,0,acept,1700,0,22,1722
Sao Paulo,200,3,4,3,acept,6800,667,87,7554
Sao Paulo,40,1,1,0,acept,900,155,12,1067
Rio de Janeiro,113,3,1,0,acept,4000,385,52,4437
Rio de Janeiro,100,2,2,2,acept,5500,233,71,5804
Sao Paulo,52,2,1,1,acept,1150,55,15,1220
Sao Paulo,34,1,1,1,not acept,2200,77,28,2305
Sao Paulo,73,3,2,3,acept,1250,155,16,1421
Belo Horizonte,210,4,5,3,acept,5200,606,70,5876
Campinas,219,4,5,2,acept,3800,472,49,4321
Belo Horizonte,70,3,2,1,acept,1600,113,22,1735
Porto Alegre,65,1,2,2,acept,2500,0,37,2537
Sao Paulo,52,1,1,0,not acept,2585,0,10,2595
Campinas,80,2,1,1,not acept,1000,75,13,1088
Rio de Janeiro,74,2,1,1,acept,1768,34,23,1825
Sao Paulo,35,1,1,1,acept,2500,22,32,2554
Campinas,70,1,1,2,acept,1450,5,22,1477
Porto Alegre,193,4,3,4,acept,4000,125,72,4197
Sao Paulo,50,1,1,0,acept,700,45,11,756
Rio de Janeiro,55,2,2,1,not acept,850,58,11,919
Campinas,44,1,1,0,acept,770,12,10,792
Sao Paulo,68,2,1,1,acept,1700,0,22,1722
Belo Horizonte,300,3,2,1,acept,2300,267,31,2598
Belo Horizonte,70,1,1,0,acept,800,153,14,967
Sao Paulo,300,4,4,2,acept,8500,267,128,8895
Belo Horizonte,203,4,3,3,not acept,6400,971,86,7457
Sao Paulo,45,2,2,0,not acept,1650,84,25,1759
Sao Paulo,240,3,4,3,acept,7000,1225,89,8314
Porto Alegre,100,2,3,2,acept,2600,100,38,2738
Porto Alegre,137,3,2,3,acept,2800,150,41,2991
Sao Paulo,61,2,2,1,acept,2000,130,26,2156
Porto Alegre,60,2,2,1,acept,1500,0,22,1522
Sao Paulo,13,1,1,0,acept,2200,5,28,2233
Sao Paulo,98,2,2,0,acept,9000,375,115,9490
Sao Paulo,138,2,3,2,acept,9800,545,125,10470
Belo Horizonte,80,2,2,2,not acept,4500,501,60,5061
Belo Horizonte,30,1,1,0,acept,525,25,7,557
Sao Paulo,63,2,2,2,not acept,2000,24,26,2050
Belo Horizonte,95,2,3,2,not acept,4500,415,60,4975
Sao Paulo,54,2,1,1,acept,1100,192,14,1306
Sao Paulo,35,1,1,1,acept,2100,140,27,2267
Porto Alegre,44,1,1,0,acept,1163,49,17,1229
Rio de Janeiro,140,2,3,2,acept,6500,667,84,7251
Sao Paulo,70,2,1,0,acept,1700,255,26,1981
Belo Horizonte,162,3,3,2,acept,2800,125,38,2963
Sao Paulo,420,4,4,4,acept,11050,3700,141,14891
Belo Horizonte,147,4,5,3,acept,2975,293,40,3308
Campinas,80,1,1,1,acept,2800,100,36,2936
Rio de Janeiro,89,2,2,2,acept,3900,266,51,4217
Sao Paulo,163,3,3,3,acept,2550,417,33,3000
Sao Paulo,42,1,1,1,acept,2100,107,27,2234
Sao Paulo,330,4,5,2,acept,12500,1334,159,13993
Sao Paulo,70,1,1,1,acept,1200,157,16,1373
Rio de Janeiro,104,3,2,1,acept,2500,134,33,2667
Rio de Janeiro,43,1,1,0,acept,1400,75,19,1494
Sao Paulo,67,2,1,1,acept,1300,91,17,1408
Sao Paulo,450,4,5,6,acept,9900,2600,126,12626
Sao Paulo,28,1,1,1,acept,1580,0,21,1601
Sao Paulo,46,1,1,1,not acept,5000,298,64,5362
Sao Paulo,34,1,1,1,acept,3800,0,49,3849
Sao Paulo,33,1,1,1,not acept,2500,158,32,2690
Belo Horizonte,70,3,1,0,not acept,1200,104,16,1320
Sao Paulo,90,3,1,1,not acept,2400,0,31,2431
Sao Paulo,75,3,3,2,acept,2000,192,26,2218
Belo Horizonte,150,6,5,8,acept,8000,625,132,8757
Sao Paulo,300,3,3,3,acept,3500,250,53,3803
Porto Alegre,70,2,2,2,not acept,1900,67,28,1995
Rio de Janeiro,320,3,4,1,not acept,5800,292,75,6167
Belo Horizonte,800,4,5,0,acept,4275,200,71,4546
Sao Paulo,400,4,7,4,acept,12000,667,181,12848
Sao Paulo,288,3,3,3,acept,3325,1295,43,4663
Rio de Janeiro,90,2,2,1,acept,1200,17,16,1233
Sao Paulo,209,4,4,3,not acept,3900,1084,50,5034
Sao Paulo,55,2,1,1,acept,2100,11,27,2138
Sao Paulo,280,4,4,7,acept,4000,278,61,4339
Sao Paulo,190,4,4,4,acept,8000,1326,102,9428
Sao Paulo,20,1,1,0,acept,1800,130,23,1953
Sao Paulo,294,3,6,3,acept,2400,512,37,2949
Sao Paulo,40,1,1,0,not acept,780,17,12,809
Sao Paulo,60,2,1,1,acept,2230,19,29,2278
Sao Paulo,400,4,3,2,acept,3390,400,43,3833
Sao Paulo,350,5,4,8,not acept,9000,762,136,9898
Belo Horizonte,68,3,2,1,acept,900,76,12,988
Porto Alegre,40,1,1,1,acept,960,15,18,993
Sao Paulo,220,3,4,3,acept,5800,1040,74,6914
Sao Paulo,200,3,3,3,acept,7000,737,106,7843
Campinas,65,2,1,1,acept,1100,100,14,1214
Sao Paulo,225,4,3,2,acept,4400,290,67,4757
Sao Paulo,55,1,1,1,not acept,3200,0,41,3241
Sao Paulo,100,2,2,1,acept,2800,125,43,2968
Sao Paulo,116,4,3,2,acept,2400,330,31,2761
Rio de Janeiro,59,2,1,0,not acept,5000,244,65,5309
Sao Paulo,380,3,2,3,acept,15000,917,191,16108
Sao Paulo,175,4,3,3,acept,13000,850,165,14015
Sao Paulo,37,1,1,1,acept,2800,0,36,2836
Sao Paulo,34,1,1,1,not acept,1750,77,23,1850
Rio de Janeiro,58,1,1,1,acept,1050,56,14,1120
Sao Paulo,72,3,1,1,acept,1600,0,21,1621
Belo Horizonte,135,4,2,2,acept,3800,294,51,4145
Rio de Janeiro,164,4,3,2,acept,5000,412,65,5477
Sao Paulo,190,3,3,2,acept,6800,392,103,7295
Rio de Janeiro,110,3,1,0,acept,2530,167,33,2730
Sao Paulo,80,2,2,2,acept,5500,0,70,5570
Rio de Janeiro,90,3,2,1,acept,1500,30,20,1550
Porto Alegre,54,2,1,1,acept,900,100,14,1014
Rio de Janeiro,100,3,2,1,acept,3800,180,49,4029
Porto Alegre,37,1,1,0,acept,650,23,10,683
Sao Paulo,51,1,2,1,not acept,2100,27,27,2154
Campinas,62,2,1,1,acept,1100,12,14,1126
Sao Paulo,70,2,2,2,not acept,3950,341,51,4342
Rio de Janeiro,63,2,1,0,acept,1110,0,15,1125
Sao Paulo,127,3,2,1,acept,6156,172,78,6406
Sao Paulo,230,4,3,2,acept,10000,917,127,11044
Campinas,102,3,3,1,acept,1500,105,20,1625
Sao Paulo,65,2,2,1,acept,1679,0,22,1701
Rio de Janeiro,67,2,1,0,acept,1500,57,20,1577
Porto Alegre,56,1,1,0,acept,700,34,11,745
Sao Paulo,172,3,3,2,acept,7000,834,89,7923
Porto Alegre,60,2,1,1,acept,540,0,10,550
Sao Paulo,80,2,2,1,not acept,4500,250,58,4808
Campinas,156,4,5,3,not acept,935,200,12,1147
Campinas,70,1,1,1,not acept,1200,40,16,1256
Rio de Janeiro,125,3,2,0,acept,5500,243,71,5814
Belo Horizonte,90,2,2,2,not acept,2600,304,35,2939
Sao Paulo,50,2,1,0,not acept,1100,80,17,1197
Rio de Janeiro,260,4,3,1,acept,5500,1052,71,6623
Sao Paulo,249,4,2,2,acept,4300,57,65,4422
Sao Paulo,179,3,5,0,acept,14500,975,184,15659
Sao Paulo,16,1,1,0,not acept,2200,0,28,2228
Belo Horizonte,350,7,5,5,acept,9000,0,148,9148
Rio de Janeiro,28,1,1,0,acept,2285,75,30,2390
Sao Paulo,102,3,2,2,acept,1900,340,25,2265
Sao Paulo,31,1,1,0,acept,2614,84,34,2732
Sao Paulo,480,4,6,3,acept,10000,500,151,10651
Sao Paulo,290,4,4,4,acept,1000,1659,13,2672
Sao Paulo,35,1,1,1,not acept,2200,242,28,2470
Sao Paulo,24,1,1,0,not acept,1420,0,18,1438
Porto Alegre,70,2,1,1,acept,1360,100,20,1480
Rio de Janeiro,55,2,1,1,not acept,1500,39,20,1559
Belo Horizonte,120,3,1,1,acept,3000,183,40,3223
Sao Paulo,160,3,3,1,acept,3370,250,43,3663
Campinas,47,1,1,1,acept,600,43,8,651
Sao Paulo,95,3,2,2,acept,1600,209,21,1830
Belo Horizonte,300,4,3,3,acept,7500,469,100,8069
Belo Horizonte,210,4,3,3,acept,3300,150,44,3494
Porto Alegre,45,1,1,1,not acept,2000,100,30,2130
Sao Paulo,87,2,1,1,acept,1220,46,16,1282
Sao Paulo,250,4,4,2,acept,6000,500,77,6577
Sao Paulo,82,3,2,2,acept,1500,159,20,1679
Campinas,93,3,2,2,acept,2300,191,30,2521
Sao Paulo,142,3,4,3,acept,6000,500,77,6577
Campinas,74,3,2,1,acept,1040,100,14,1154
Porto Alegre,36,1,1,0,not acept,1290,87,19,1396
Sao Paulo,33,1,1,0,acept,3999,0,51,4050
Rio de Janeiro,80,2,1,0,not acept,1000,98,13,1111
Porto Alegre,90,2,1,1,acept,1350,53,20,1423
Sao Paulo,195,2,3,3,acept,9200,250,117,9567
Sao Paulo,186,3,2,2,acept,2200,185,28,2413
Sao Paulo,275,4,4,3,acept,6800,1250,87,8137
Belo Horizonte,230,4,4,5,acept,7500,1900,100,9500
Porto Alegre,42,1,1,1,acept,2700,0,40,2740
Rio de Janeiro,388,4,4,1,not acept,15000,104,194,15298
Sao Paulo,94,3,3,2,acept,2433,0,31,2464
Sao Paulo,260,4,2,2,acept,6000,594,77,6671
Campinas,65,3,2,1,not acept,1100,60,14,1174
Rio de Janeiro,76,2,1,0,acept,1280,57,17,1354
Sao Paulo,131,4,4,3,not acept,6000,818,77,6895
Sao Paulo,225,3,3,4,acept,10500,750,134,11384
Belo Horizonte,71,3,2,2,acept,970,149,13,1132
Belo Horizonte,201,4,4,3,acept,5300,852,71,6223
Rio de Janeiro,570,3,6,2,acept,14000,334,181,14515
Porto Alegre,53,2,2,1,acept,1275,59,19,1353
Belo Horizonte,240,4,5,3,acept,3500,350,47,3897
Rio de Janeiro,50,1,1,0,acept,2700,100,35,2835
Porto Alegre,68,2,2,1,acept,1800,82,27,1909
Sao Paulo,54,1,1,1,not acept,5000,359,64,5423
Sao Paulo,178,2,3,4,not acept,2500,903,32,3435
Porto Alegre,50,1,1,0,acept,1100,0,17,1117
Sao Paulo,212,4,3,6,acept,2983,237,45,3265
Sao Paulo,380,4,6,4,acept,4900,1193,63,6156
Sao Paulo,138,2,2,1,acept,7000,89,89,7178
Belo Horizonte,180,4,3,3,not acept,4200,407,56,4663
Porto Alegre,43,1,1,1,acept,800,82,12,894
Rio de Janeiro,48,1,1,1,acept,2800,0,37,2837
Rio de Janeiro,180,3,3,0,acept,7600,378,98,8076
Campinas,70,1,2,1,acept,2500,0,32,2532
Porto Alegre,155,2,2,2,acept,2300,94,34,2428
Sao Paulo,262,3,4,4,acept,15000,2050,191,17241
Sao Paulo,25,1,1,1,acept,2100,64,27,2191
Sao Paulo,50,3,1,1,not acept,2500,126,32,2658
Sao Paulo,108,3,2,1,acept,5000,127,64,5191
Sao Paulo,170,3,2,1,acept,4500,85,58,4643
Sao Paulo,60,1,1,0,acept,1000,34,16,1050
Sao Paulo,78,3,2,2,acept,2400,117,31,2548
Belo Horizonte,170,3,2,0,acept,5000,320,82,5402
Rio de Janeiro,20,1,1,0,acept,600,0,8,608
Porto Alegre,500,5,4,4,not acept,4000,1250,59,5309
Sao Paulo,248,3,4,4,acept,14000,966,178,15144
Sao Paulo,145,3,3,2,acept,5500,0,70,5570
Sao Paulo,50,1,1,1,not acept,7800,359,99,8258
Porto Alegre,44,1,2,0,acept,1350,10,20,1380
Sao Paulo,200,3,2,2,acept,4500,250,68,4818
Belo Horizonte,58,2,2,1,acept,999,99,14,1112
Sao Paulo,280,3,4,4,acept,15000,1500,191,16691
Sao Paulo,52,1,1,1,acept,3000,292,39,3331
Sao Paulo,271,3,3,2,acept,8000,959,121,9080
Sao Paulo,223,4,4,7,acept,5500,1169,83,6752
Sao Paulo,263,4,5,4,acept,12500,1588,159,14247
Porto Alegre,157,4,3,1,acept,3500,169,52,3721
Sao Paulo,323,5,5,3,acept,4800,582,73,5455
Sao Paulo,80,2,2,1,not acept,2188,0,10,2198
Sao Paulo,70,2,2,2,acept,6000,449,77,6526
Belo Horizonte,74,3,2,1,acept,1000,92,14,1106
Belo Horizonte,66,3,1,2,acept,1100,73,15,1188
Sao Paulo,80,2,1,1,acept,1275,0,17,1292
Porto Alegre,100,3,2,2,acept,3000,125,54,3179
Sao Paulo,218,4,4,2,acept,5500,692,70,6262
Rio de Janeiro,73,2,1,1,acept,1200,119,16,1335
Rio de Janeiro,230,4,2,2,acept,13000,1839,168,15007
Sao Paulo,80,3,5,2,not acept,12000,1000,153,13153
Belo Horizonte,180,3,3,3,acept,4200,227,56,4483
Rio de Janeiro,85,3,2,1,acept,2500,264,33,2797
Sao Paulo,37,1,1,0,not acept,900,75,14,989
Porto Alegre,65,2,1,0,acept,985,21,15,1021
Sao Paulo,440,4,3,2,acept,8000,1702,102,9804
Rio de Janeiro,57,2,1,0,acept,1530,0,20,1550
Sao Paulo,74,3,2,1,acept,1715,100,22,1837
Sao Paulo,180,3,4,3,acept,1800,902,23,2725
Sao Paulo,198,3,3,0,acept,6000,715,77,6792
Rio de Janeiro,170,3,4,3,acept,5000,757,65,5822
Sao Paulo,240,3,4,3,acept,8500,1167,108,9775
Sao Paulo,59,2,2,0,not acept,1990,25,26,2041
Sao Paulo,525,5,4,4,acept,8330,2167,126,10623
Sao Paulo,226,4,4,4,acept,3000,2488,39,5527
Sao Paulo,60,2,2,2,acept,1950,67,30,2047
Porto Alegre,43,2,1,0,not acept,1570,42,23,1635
Sao Paulo,158,4,4,3,acept,6600,375,84,7059
Porto Alegre,42,1,1,1,acept,1400,17,21,1438
Sao Paulo,50,1,1,0,not acept,1250,34,19,1303
Belo Horizonte,66,2,1,1,acept,550,26,8,584
Sao Paulo,39,1,1,1,not acept,4200,125,54,4379
Sao Paulo,64,1,2,1,acept,3700,185,47,3932
Sao Paulo,70,3,2,0,acept,1500,60,23,1583
Sao Paulo,30,1,1,1,acept,1930,0,25,1955
Sao Paulo,135,3,3,0,not acept,3810,167,49,4026
Sao Paulo,170,3,2,1,acept,6500,110,83,6693
Rio de Janeiro,120,3,2,1,acept,7500,334,97,7931
Belo Horizonte,92,2,1,0,acept,1200,60,20,1280
Belo Horizonte,183,4,4,4,acept,9300,803,124,10227
Sao Paulo,210,3,3,2,not acept,8667,834,110,9611
Rio de Janeiro,30,1,1,0,acept,900,94,12,1006
Campinas,119,3,3,2,acept,5500,133,70,5703
Rio de Janeiro,298,5,3,2,acept,4100,417,53,4570
Belo Horizonte,260,3,2,4,acept,2600,268,43,2911
Belo Horizonte,201,4,4,4,acept,7300,113,98,7511
Sao Paulo,200,3,4,4,not acept,4000,400,61,4461
Sao Paulo,60,2,1,1,acept,3800,112,49,3961
Rio de Janeiro,70,2,1,1,acept,2000,59,31,2090
Sao Paulo,135,3,2,1,acept,7500,77,96,7673
Sao Paulo,336,6,2,3,acept,6350,1125,96,7571
Sao Paulo,300,3,4,6,acept,3200,167,49,3416
Rio de Janeiro,600,5,5,4,acept,8000,1585,104,9689
Sao Paulo,60,3,3,2,acept,2700,273,41,3014
Sao Paulo,254,3,4,4,not acept,7000,930,89,8019
Sao Paulo,210,3,5,4,acept,11900,960,151,13011
Sao Paulo,178,3,4,2,not acept,10000,834,127,10961
Sao Paulo,45,1,1,0,not acept,1000,34,16,1050
Rio de Janeiro,70,3,1,0,acept,750,138,10,898
Sao Paulo,181,4,5,3,acept,2600,579,33,3212
Belo Horizonte,72,2,2,1,acept,1700,90,23,1813
Sao Paulo,60,2,2,1,acept,5550,142,71,5763
Sao Paulo,55,2,1,1,acept,1800,0,23,1823
Sao Paulo,94,1,2,2,not acept,13000,384,165,13549
Rio de Janeiro,210,3,2,1,acept,14080,700,182,14962
Sao Paulo,37,1,1,1,acept,4000,50,51,4101
Sao Paulo,41,2,1,0,acept,1200,0,16,1216
Sao Paulo,240,3,4,3,acept,11000,1834,140,12974
Porto Alegre,70,2,1,0,acept,1105,84,17,1206
Belo Horizonte,55,3,1,1,not acept,800,42,11,853
Rio de Janeiro,150,3,1,0,acept,1500,0,20,1520
Rio de Janeiro,55,2,2,1,acept,1330,30,18,1378
Sao Paulo,390,3,3,2,acept,7500,650,113,8263
Porto Alegre,73,3,2,1,acept,1777,84,26,1887
Campinas,57,1,1,1,acept,2600,131,33,2764
Rio de Janeiro,93,3,1,0,acept,1500,70,20,1590
Rio de Janeiro,88,2,2,2,acept,2500,430,33,2963
Sao Paulo,330,4,6,3,acept,15000,2475,191,17666
Sao Paulo,130,3,3,2,acept,2350,255,30,2635
Sao Paulo,170,4,3,2,not acept,10000,770,127,10897
Sao Paulo,220,3,4,4,acept,5500,1084,70,6654
Sao Paulo,59,2,1,1,acept,1600,0,21,1621
Sao Paulo,500,4,4,3,acept,10800,988,163,11951
Rio de Janeiro,70,3,2,0,acept,1500,50,20,1570
Rio de Janeiro,55,1,1,1,not acept,1250,25,17,1292
Belo Horizonte,35,1,1,1,acept,1080,100,15,1195
Sao Paulo,33,1,1,1,acept,3200,123,41,3364
Belo Horizonte,80,3,2,1,acept,1200,97,16,1313
Belo Horizonte,2000,4,2,3,acept,4956,200,82,5238
Sao Paulo,60,1,1,1,not acept,3250,131,42,3423
Porto Alegre,48,2,1,0,acept,950,36,14,1000
Campinas,53,1,1,1,acept,650,34,9,693
Sao Paulo,96,3,1,1,acept,2800,0,36,2836
Sao Paulo,25,1,1,0,not acept,1750,0,23,1773
Sao Paulo,23,1,1,1,acept,2300,59,30,2389
Sao Paulo,83,1,1,1,not acept,6000,255,77,6332
Rio de Janeiro,25,1,1,0,acept,700,0,10,710
Sao Paulo,45,1,1,1,not acept,1800,177,23,2000
Porto Alegre,70,2,2,2,acept,1800,0,27,1827
Sao Paulo,80,1,1,0,acept,1200,1,19,1220
Sao Paulo,78,1,1,0,acept,2522,25,32,2579
Belo Horizonte,45,1,1,0,not acept,1100,8,15,1123
Sao Paulo,43,1,1,0,acept,680,220,9,909
Sao Paulo,250,5,4,5,acept,2800,800,36,3636
Sao Paulo,350,5,6,6,acept,15000,417,191,15608
Campinas,190,4,4,2,acept,3200,192,15,3407
Sao Paulo,117,3,4,4,acept,2700,50,35,2785
Rio de Janeiro,75,2,1,1,not acept,580,69,8,657
Belo Horizonte,113,4,2,2,acept,4900,489,66,5455
Porto Alegre,46,1,1,1,acept,650,16,10,676
Sao Paulo,100,3,2,1,acept,3500,98,53,3651
Sao Paulo,35,1,1,0,not acept,500,0,8,508
Sao Paulo,300,4,5,1,acept,8550,400,109,9059
Campinas,57,2,1,1,acept,1000,36,13,1049
Sao Paulo,35,1,1,0,acept,1600,32,21,1653
Rio de Janeiro,110,3,2,2,acept,2750,92,36,2878
Sao Paulo,106,2,3,2,acept,3980,209,51,4240
Rio de Janeiro,120,3,3,1,acept,3500,147,46,3693
Porto Alegre,40,1,1,0,not acept,2000,0,30,2030
Rio de Janeiro,97,3,1,0,acept,2080,100,27,2207
Rio de Janeiro,160,3,1,2,acept,2800,151,43,2994
Sao Paulo,80,4,4,3,acept,6000,0,77,6077
Sao Paulo,297,4,5,5,acept,11700,2482,149,14331
Sao Paulo,400,5,4,6,acept,6500,0,98,6598
Rio de Janeiro,90,3,1,0,acept,1500,140,20,1660
Rio de Janeiro,93,3,3,1,acept,2990,235,39,3264
Sao Paulo,37,1,1,1,acept,2700,145,35,2880
Sao Paulo,300,4,2,2,acept,6500,1091,83,7674
Sao Paulo,217,3,4,3,acept,1900,917,25,2842
Sao Paulo,77,3,2,2,not acept,6200,205,79,6484
Sao Paulo,150,3,4,3,not acept,7500,622,54,8176
Sao Paulo,60,2,1,0,acept,1654,0,21,1675
Sao Paulo,140,3,2,1,acept,2900,148,37,3085
Belo Horizonte,96,3,2,1,acept,2000,95,27,2122
Sao Paulo,55,1,1,1,acept,5600,80,71,5751
Sao Paulo,170,3,2,2,acept,4200,309,64,4573
Rio de Janeiro,70,2,2,1,acept,1400,211,19,1630
Sao Paulo,400,10,9,8,acept,8330,550,126,9006
Belo Horizonte,209,4,4,4,acept,7300,587,98,7985
Rio de Janeiro,91,2,2,2,acept,5500,637,71,6208
Sao Paulo,328,3,4,4,acept,6000,800,77,6877
Belo Horizonte,92,3,3,2,acept,1600,112,22,1734
Rio de Janeiro,50,2,1,1,acept,1650,0,22,1672
Rio de Janeiro,85,2,1,0,acept,2800,217,43,3060
Sao Paulo,72,2,2,0,acept,3000,1,39,3040
Rio de Janeiro,140,4,2,1,acept,3900,350,51,4301
Sao Paulo,70,2,2,1,not acept,1500,80,20,1600
Sao Paulo,130,3,3,3,not acept,3500,348,45,3893
Sao Paulo,387,4,6,6,acept,6647,2235,85,8967
Campinas,126,3,3,2,acept,3600,167,46,3813
Sao Paulo,104,3,2,2,not acept,3800,0,49,3849
Sao Paulo,550,4,4,4,acept,14000,1334,211,15545
Sao Paulo,51,1,1,0,acept,1950,84,25,2059
Belo Horizonte,140,4,3,3,acept,3400,250,46,3696
Sao Paulo,90,2,1,1,acept,3000,50,39,3089
Sao Paulo,70,2,2,2,acept,1750,209,23,1982
Rio de Janeiro,140,3,2,1,not acept,4000,271,52,4323
Rio de Janeiro,20,1,1,0,acept,1250,30,17,1297
Sao Paulo,365,3,5,2,acept,8500,899,108,9507
Porto Alegre,200,2,3,2,acept,12750,500,187,13437
Sao Paulo,40,1,1,0,not acept,850,41,13,904
Campinas,66,1,1,1,acept,5000,62,64,5126
Sao Paulo,161,1,2,2,not acept,7000,54,89,7143
Rio de Janeiro,75,2,1,0,acept,2350,80,31,2461
Campinas,110,3,1,2,acept,1900,64,29,1993
Campinas,82,2,1,1,acept,600,105,8,713
Sao Paulo,23,1,1,0,acept,1800,0,23,1823
Sao Paulo,65,3,2,1,acept,1740,135,23,1898
Porto Alegre,40,1,1,0,acept,816,0,15,831
Campinas,129,3,2,2,acept,3310,235,42,3587
Sao Paulo,114,1,1,1,acept,2800,208,36,3044
Sao Paulo,200,2,2,2,acept,3000,167,46,3213
Porto Alegre,101,3,2,2,acept,4200,142,62,4404
Belo Horizonte,50,2,1,0,not acept,950,50,16,1016
Sao Paulo,400,4,3,2,acept,8000,1417,121,9538
Sao Paulo,71,2,1,1,acept,2559,0,32,2591
Porto Alegre,72,2,1,0,not acept,900,42,14,956
Sao Paulo,250,4,4,3,not acept,8000,888,102,8990
Campinas,50,2,1,1,acept,1000,0,13,1013
Campinas,180,3,2,1,acept,2200,201,28,2429
Porto Alegre,31,1,1,0,acept,586,28,9,623
Rio de Janeiro,86,2,1,0,acept,1650,60,22,1732
Belo Horizonte,200,4,3,2,acept,4000,378,54,4432
Sao Paulo,130,3,2,1,acept,5500,300,70,5870
Porto Alegre,38,1,1,0,acept,1800,42,27,1869
Sao Paulo,20,1,1,0,not acept,1950,0,25,1975
Porto Alegre,140,3,2,2,acept,3200,167,47,3414
Porto Alegre,40,1,1,0,acept,930,21,14,965
Sao Paulo,65,2,2,1,acept,3800,7,50,3857
Belo Horizonte,300,5,3,3,acept,8500,234,140,8874
Porto Alegre,30,1,1,0,not acept,650,30,10,690
Sao Paulo,41,1,1,0,acept,1760,45,23,1828
Belo Horizonte,98,3,2,1,not acept,1400,116,19,1535
Campinas,50,1,1,0,not acept,702,20,9,731
Belo Horizonte,68,2,2,2,acept,3900,9,52,3961
Sao Paulo,193,3,3,3,not acept,6500,834,83,7417
Sao Paulo,32,1,1,1,acept,1880,0,24,1904
Rio de Janeiro,36,1,1,0,acept,1300,0,17,1317
Sao Paulo,167,3,1,0,acept,1500,0,23,1523
Rio de Janeiro,25,1,1,0,acept,2006,67,26,2099
Rio de Janeiro,55,2,2,1,acept,1330,30,18,1378
Sao Paulo,50,2,1,1,acept,1500,47,20,1567
Rio de Janeiro,125,2,4,1,not acept,6500,500,84,7084
Porto Alegre,85,3,2,2,acept,3400,100,50,3550
Porto Alegre,170,2,2,0,acept,2700,184,40,2924
Sao Paulo,300,5,6,2,not acept,8000,800,121,8921
Sao Paulo,23,1,1,1,acept,2800,99,36,2935
Porto Alegre,160,2,4,2,acept,7000,167,103,7270
Belo Horizonte,210,3,5,4,acept,7200,169,96,7465
Sao Paulo,120,3,3,2,acept,4200,359,64,4623
Rio de Janeiro,406,3,4,2,acept,15000,1167,194,16361
Campinas,63,2,1,1,not acept,1750,90,23,1863
Sao Paulo,127,3,4,2,not acept,3500,250,45,3795
Sao Paulo,90,3,2,2,not acept,5000,384,64,5448
Belo Horizonte,373,4,5,7,acept,11500,522,189,12211
Rio de Janeiro,60,2,1,1,acept,1300,53,17,1370
Sao Paulo,650,4,6,5,acept,10000,834,151,10985
Sao Paulo,250,3,3,2,acept,5500,792,70,6362
Belo Horizonte,318,4,2,2,not acept,4500,179,74,4753
Sao Paulo,22,1,1,0,acept,976,0,15,991
Rio de Janeiro,64,2,1,0,acept,2700,250,35,2985
Sao Paulo,172,4,5,3,acept,5500,943,70,6513
Sao Paulo,108,3,3,2,not acept,2200,253,28,2481
Sao Paulo,31,1,1,1,acept,2700,83,35,2818
Belo Horizonte,90,2,1,2,acept,1800,121,24,1945
Rio de Janeiro,81,2,1,0,acept,2650,300,35,2985
Rio de Janeiro,80,2,1,1,not acept,1900,50,25,1975
Sao Paulo,243,3,2,1,acept,8000,450,102,8552
Rio de Janeiro,67,2,1,0,acept,6600,249,86,6935
Sao Paulo,160,3,1,1,acept,3000,298,46,3344
Porto Alegre,67,2,1,1,acept,1200,284,18,1502
Sao Paulo,90,3,2,3,acept,1500,201,20,1721
Sao Paulo,186,4,4,3,acept,5600,584,71,6255
Rio de Janeiro,15,1,1,0,acept,700,0,10,710
Porto Alegre,62,2,2,2,acept,1390,60,21,1471
Sao Paulo,215,4,6,3,acept,5700,959,73,6732
Sao Paulo,28,1,1,0,acept,1764,0,23,1787
Sao Paulo,240,4,5,3,acept,15000,1250,191,16441
Sao Paulo,70,2,2,1,not acept,2980,437,38,3455
Sao Paulo,145,2,2,2,acept,7630,538,97,8265
Porto Alegre,47,1,1,1,not acept,2200,0,33,2233
Sao Paulo,62,2,2,1,acept,2500,45,32,2577
Belo Horizonte,270,4,5,6,acept,8000,317,132,8449
Sao Paulo,266,3,5,1,acept,4320,391,55,4766
Sao Paulo,109,1,1,2,not acept,11500,479,146,12125
Sao Paulo,24,1,1,0,acept,2020,0,26,2046
Campinas,80,3,2,2,acept,2500,250,32,2782
Sao Paulo,500,4,8,4,acept,14000,917,211,15128
Sao Paulo,150,3,1,1,acept,4800,294,61,5155
Belo Horizonte,110,2,2,2,not acept,1346,88,10,1444
Sao Paulo,110,2,3,2,not acept,11500,502,146,12148
Sao Paulo,77,3,1,2,acept,3500,230,45,3775
Sao Paulo,850,5,7,8,not acept,4000,0,51,4051
Campinas,58,1,1,1,acept,1200,0,16,1216
Sao Paulo,145,3,3,1,acept,6600,555,84,7239
Porto Alegre,42,1,1,1,acept,1200,54,18,1272
Porto Alegre,62,2,1,1,acept,1150,70,17,1237
Sao Paulo,65,2,1,0,acept,1500,24,23,1547
Sao Paulo,33,1,1,1,not acept,3000,125,39,3164
Sao Paulo,140,3,5,2,acept,3900,250,59,4209
Porto Alegre,326,3,2,3,acept,3900,2760,70,6730
Rio de Janeiro,70,2,2,1,not acept,2500,67,33,2600
Rio de Janeiro,25,1,1,0,acept,1112,0,7,1119
Sao Paulo,67,2,2,2,acept,2372,0,8,2380
Campinas,50,1,1,0,acept,550,14,7,571
Sao Paulo,215,3,4,4,acept,6000,865,77,6942
Campinas,55,2,1,1,acept,750,66,10,826
Sao Paulo,264,3,4,3,acept,6770,0,86,6856
Rio de Janeiro,270,4,2,1,not acept,7500,750,97,8347
Sao Paulo,40,1,1,1,not acept,4860,154,62,5076
Sao Paulo,90,2,2,0,not acept,1800,375,23,2198
Rio de Janeiro,50,2,2,1,acept,950,59,13,1022
Sao Paulo,68,2,2,2,acept,6600,0,84,6684
Sao Paulo,41,1,1,0,acept,2470,0,32,2502
Sao Paulo,420,3,5,5,acept,8200,1084,124,9408
Sao Paulo,150,3,2,1,acept,2500,0,38,2538
Sao Paulo,220,4,5,3,acept,7800,1000,99,8899
Sao Paulo,113,2,2,1,acept,3000,50,39,3089
Sao Paulo,268,4,4,4,acept,6000,899,77,6976
Porto Alegre,74,3,1,1,acept,1090,42,16,1148
Sao Paulo,53,2,1,1,not acept,2400,21,31,2452
Porto Alegre,64,1,1,1,acept,1200,48,18,1266
Porto Alegre,45,1,1,1,acept,2550,120,38,2708
Campinas,120,3,3,2,not acept,1850,0,24,1874
Sao Paulo,167,3,3,4,acept,5500,807,70,6377
Porto Alegre,250,4,2,1,acept,2700,209,48,2957
Belo Horizonte,28,1,1,1,not acept,1100,0,15,1115
Sao Paulo,135,2,3,1,not acept,8000,650,102,8752
Porto Alegre,42,1,1,0,acept,1250,25,19,1294
Belo Horizonte,156,4,4,2,acept,3500,248,47,3795
Sao Paulo,300,4,5,5,not acept,1990,10830,26,12846
Belo Horizonte,150,4,2,3,acept,3500,380,47,3927
Sao Paulo,54,2,2,1,acept,1927,100,12,2039
Sao Paulo,38,1,1,0,not acept,1650,0,25,1675
Belo Horizonte,474,5,5,7,acept,15000,990,246,16236
Sao Paulo,450,5,4,3,acept,12000,1201,181,13382
Belo Horizonte,343,4,3,4,acept,7000,320,115,7435
Sao Paulo,180,3,2,4,acept,3000,0,46,3046
Sao Paulo,100,2,2,2,acept,2000,0,31,2031
Sao Paulo,102,2,3,2,acept,2500,0,38,2538
Rio de Janeiro,470,4,5,3,acept,6580,1650,85,8315
Rio de Janeiro,140,3,3,1,acept,2820,343,37,3200
Sao Paulo,380,4,1,0,acept,2890,150,25,3065
Porto Alegre,140,2,2,1,acept,3000,150,44,3194
Sao Paulo,520,3,4,3,acept,7000,645,106,7751
Sao Paulo,130,3,2,3,acept,7450,167,112,7729
Sao Paulo,49,1,1,1,acept,2985,0,38,3023
Rio de Janeiro,28,1,1,0,not acept,1099,0,15,1114
Campinas,58,2,1,1,acept,870,75,12,957
Sao Paulo,32,1,1,1,not acept,2150,0,28,2178
Sao Paulo,48,2,1,1,not acept,2000,26,26,2052
Sao Paulo,30,1,1,0,acept,1830,0,24,1854
Sao Paulo,26,1,1,0,acept,2650,55,34,2739
Rio de Janeiro,65,2,1,0,acept,1285,93,17,1395
Sao Paulo,98,3,2,2,acept,2290,25,35,2350
Sao Paulo,234,3,4,4,acept,5000,1210,64,6274
Campinas,59,2,1,1,acept,1190,47,16,1253
Sao Paulo,97,2,3,1,acept,6500,120,83,6703
Belo Horizonte,65,2,2,1,acept,1100,70,15,1185
Porto Alegre,42,1,1,1,acept,2300,42,34,2376
Rio de Janeiro,94,3,2,1,acept,3300,192,43,3535
Belo Horizonte,147,4,2,3,acept,4700,330,63,5093
Sao Paulo,73,3,2,2,acept,2520,192,32,2744
Rio de Janeiro,40,1,1,0,not acept,2200,35,29,2264
Sao Paulo,350,3,5,5,acept,3080,200,47,3327
Sao Paulo,384,3,3,4,not acept,11400,1142,172,12714
Sao Paulo,48,1,1,2,acept,7000,245,89,7334
Rio de Janeiro,96,3,2,1,not acept,2500,165,33,2698
Porto Alegre,55,2,1,0,acept,1125,25,17,1167
Porto Alegre,330,4,4,3,acept,6994,403,125,7522
Porto Alegre,49,1,1,0,acept,900,24,14,938
Rio de Janeiro,170,3,2,1,acept,3500,0,46,3546
Sao Paulo,243,2,3,2,acept,4619,559,70,5248
Sao Paulo,216,4,4,3,acept,8980,0,114,9094
Rio de Janeiro,60,2,1,1,acept,800,58,11,869
Sao Paulo,200,3,4,2,acept,2500,500,38,3038
Porto Alegre,48,1,1,0,acept,700,28,11,739
Campinas,130,3,2,6,acept,2200,182,34,2416
Rio de Janeiro,55,2,1,1,acept,1080,185,14,1279
Sao Paulo,200,4,3,2,acept,5628,575,85,6288
Campinas,101,3,2,2,acept,2200,119,28,2347
Sao Paulo,20,1,1,0,acept,1650,59,21,1730
Sao Paulo,97,3,3,2,acept,2500,275,32,2807
Sao Paulo,83,2,2,1,acept,4800,174,61,5035
Porto Alegre,47,1,1,1,acept,610,6,9,625
Sao Paulo,110,2,2,1,acept,4348,196,56,4600
Sao Paulo,140,4,4,2,acept,3100,153,40,3293
Sao Paulo,242,3,4,3,acept,7000,250,89,7339
Sao Paulo,35,1,1,0,acept,1300,0,17,1317
Rio de Janeiro,100,2,2,0,acept,4700,375,61,5136
Sao Paulo,134,3,3,1,acept,3500,200,45,3745
Porto Alegre,50,2,1,1,not acept,1000,35,18,1053
Campinas,67,3,1,1,acept,1200,26,16,1242
Sao Paulo,150,2,3,0,acept,4000,124,61,4185
Sao Paulo,174,3,4,3,acept,13500,814,172,14486
Sao Paulo,120,3,3,1,acept,2800,75,43,2918
Porto Alegre,90,4,2,0,not acept,1700,152,31,1883
Sao Paulo,16,1,1,0,not acept,850,30,11,891
Campinas,110,3,1,1,acept,1200,25,5,1230
Sao Paulo,277,2,3,4,acept,13000,1550,165,14715
Sao Paulo,79,3,1,1,not acept,1405,0,18,1423
Belo Horizonte,180,4,3,2,acept,3260,390,44,3694
Sao Paulo,300,3,3,2,acept,7650,500,97,8247
Sao Paulo,270,2,3,4,acept,3270,169,50,3489
Porto Alegre,25,1,1,0,acept,790,13,12,815
Sao Paulo,78,1,1,1,acept,3850,225,49,4124
Sao Paulo,82,2,2,1,acept,2450,192,32,2674
Belo Horizonte,55,2,1,2,acept,1100,0,15,1115
Sao Paulo,420,4,5,4,acept,10000,667,151,10818
Campinas,115,2,3,2,acept,3500,220,45,3765
Belo Horizonte,45,2,1,1,acept,1000,0,14,1014
Sao Paulo,47,3,1,1,acept,1420,0,18,1438
Sao Paulo,250,3,3,2,acept,2500,300,32,2832
Rio de Janeiro,95,3,2,1,acept,5000,36,65,5101
Rio de Janeiro,54,2,2,1,acept,700,142,10,852
Belo Horizonte,200,3,2,2,acept,12000,369,197,12566
Sao Paulo,380,3,3,5,acept,10900,1713,164,12777
Rio de Janeiro,60,2,2,0,acept,4000,1,52,4053
Sao Paulo,300,3,3,2,acept,6000,197,91,6288
Belo Horizonte,75,3,1,1,not acept,1100,80,15,1195
Belo Horizonte,32,1,1,1,acept,1500,126,20,1646
Rio de Janeiro,24,1,1,0,acept,1400,21,19,1440
Sao Paulo,49,1,1,1,not acept,3200,0,13,3213
Porto Alegre,50,2,1,0,acept,1400,41,21,1462
Rio de Janeiro,40,1,1,0,acept,2200,61,29,2290
Sao Paulo,30,1,1,1,not acept,2000,150,26,2176
Sao Paulo,70,2,1,1,acept,1100,14,14,1128
Campinas,146,2,1,1,acept,1620,128,21,1769
Rio de Janeiro,120,2,2,0,acept,4750,389,62,5201
Campinas,67,3,1,1,not acept,890,40,12,942
Belo Horizonte,347,4,4,3,acept,9000,589,120,9709
Belo Horizonte,80,2,2,1,not acept,1705,61,14,1780
Sao Paulo,40,2,1,0,acept,2500,129,32,2661
Campinas,44,2,1,1,acept,1020,0,13,1033
Sao Paulo,80,2,1,0,not acept,2200,59,28,2287
Porto Alegre,106,3,3,1,acept,3000,230,44,3274
Campinas,137,3,4,2,acept,3800,257,49,4106
Sao Paulo,248,3,4,4,acept,9000,1531,136,10667
Sao Paulo,350,4,3,2,acept,13500,1006,203,14709
Rio de Janeiro,90,2,1,2,not acept,2800,13,37,2850
Sao Paulo,16,1,1,0,not acept,1420,0,18,1438
Sao Paulo,108,3,3,2,acept,3400,334,44,3778
Rio de Janeiro,120,3,2,1,acept,2414,223,32,2669
Campinas,54,2,1,1,acept,1800,72,23,1895
Sao Paulo,190,1,2,10,acept,3900,34,59,3993
Belo Horizonte,100,3,3,1,acept,1800,105,24,1929
Belo Horizonte,120,3,2,1,acept,2100,179,28,2307
Sao Paulo,40,1,1,1,acept,5000,115,36,5151
Sao Paulo,185,2,2,2,not acept,1850,59,28,1937
Rio de Janeiro,50,1,1,0,acept,2300,0,30,2330
Sao Paulo,233,3,6,5,acept,6000,506,91,6597
Sao Paulo,47,2,2,2,acept,2611,24,34,2669
Sao Paulo,49,1,1,0,acept,4100,89,52,4241
Porto Alegre,76,3,2,2,acept,2100,0,31,2131
Rio de Janeiro,60,2,1,0,acept,1300,0,17,1317
Sao Paulo,200,4,5,3,acept,4500,834,58,5392
Rio de Janeiro,200,3,4,2,acept,5000,306,65,5371
Porto Alegre,184,3,3,2,acept,5445,264,80,5789
Sao Paulo,117,3,4,2,acept,6100,490,78,6668
Porto Alegre,80,3,1,0,not acept,1250,0,23,1273
Rio de Janeiro,60,2,2,1,not acept,2000,67,26,2093
Sao Paulo,140,3,2,1,acept,8200,0,124,8324
Rio de Janeiro,55,1,1,0,not acept,1500,60,20,1580
Sao Paulo,131,3,2,1,acept,4200,197,54,4451
Sao Paulo,142,3,4,3,acept,5000,414,64,5478
Campinas,35,1,1,1,acept,1100,13,14,1127
Porto Alegre,40,1,1,0,acept,890,21,13,924
Sao Paulo,57,1,1,0,acept,6000,17,77,6094
Porto Alegre,30,1,1,0,acept,890,34,13,937
Rio de Janeiro,800,5,7,5,acept,15000,334,229,15563
Porto Alegre,250,2,2,0,acept,4000,335,72,4407
Sao Paulo,37,1,1,1,acept,1500,150,20,1670
Belo Horizonte,240,4,5,3,not acept,10000,962,134,11096
Rio de Janeiro,95,3,2,1,acept,1650,76,22,1748
Sao Paulo,30,1,1,0,not acept,980,0,13,993
Sao Paulo,380,7,7,6,acept,5800,417,88,6305
Sao Paulo,50,2,1,0,acept,1900,42,25,1967
Rio de Janeiro,32,1,1,1,not acept,900,0,12,912
Sao Paulo,104,3,3,2,acept,6000,0,77,6077
Sao Paulo,31,1,1,0,not acept,1575,0,20,1595
Sao Paulo,700,4,5,2,acept,8000,402,102,8504
Campinas,138,3,3,0,acept,7000,84,89,7173
Sao Paulo,77,2,1,1,acept,4500,18,58,4576
Sao Paulo,35,1,1,0,not acept,1305,0,17,1322
Sao Paulo,216,4,3,4,acept,3500,659,45,4204
Campinas,60,2,1,1,acept,1000,0,13,1013
Belo Horizonte,115,3,2,2,acept,3000,71,50,3121
Belo Horizonte,222,4,3,4,acept,3000,153,50,3203
Rio de Janeiro,84,3,2,1,acept,2600,420,34,3054
Sao Paulo,156,3,3,1,not acept,4150,0,53,4203
Sao Paulo,34,1,1,0,acept,1050,50,16,1116
Porto Alegre,60,2,1,1,acept,1150,50,17,1217
Porto Alegre,50,2,2,1,acept,1300,34,19,1353
Sao Paulo,210,3,3,2,acept,5500,690,70,6260
Sao Paulo,240,4,2,4,acept,8000,0,121,8121
Sao Paulo,336,4,6,5,acept,7500,0,96,7596
Campinas,60,2,1,1,acept,790,17,11,818
Belo Horizonte,194,3,3,2,acept,4000,324,54,4378
Sao Paulo,70,1,1,0,acept,2000,0,26,2026
Sao Paulo,46,1,1,0,acept,1600,0,21,1621
Rio de Janeiro,185,3,2,2,not acept,6000,0,78,6078
Sao Paulo,90,1,2,2,not acept,8000,500,102,8602
Belo Horizonte,90,3,2,1,acept,1400,111,19,1530
Sao Paulo,175,1,3,2,not acept,4142,0,53,4195
Rio de Janeiro,140,3,2,1,acept,4200,331,55,4586
Sao Paulo,400,2,5,4,acept,6000,484,91,6575
Porto Alegre,127,3,2,1,acept,3000,120,44,3164
Sao Paulo,60,2,2,1,acept,3300,96,42,3438
Belo Horizonte,230,3,3,3,acept,4000,408,54,4462
Sao Paulo,48,1,1,1,not acept,6698,166,85,6949
Campinas,62,3,2,1,acept,2975,59,38,3072
Sao Paulo,110,3,2,1,acept,4500,262,58,4820
Sao Paulo,80,3,3,2,not acept,2800,0,36,2836
Rio de Janeiro,54,1,1,0,acept,2400,286,31,2717
Sao Paulo,42,1,1,1,not acept,4400,41,56,4497
Belo Horizonte,55,2,1,1,acept,850,60,12,922
Sao Paulo,161,3,5,3,acept,6500,567,83,7150
Belo Horizonte,70,2,1,1,acept,1100,74,15,1189
Sao Paulo,35,1,1,0,acept,1300,40,17,1357
Sao Paulo,360,4,4,4,acept,9000,2507,115,11622
Belo Horizonte,45,1,1,1,acept,2900,9,39,2948
Sao Paulo,55,1,1,0,not acept,730,0,10,740
Rio de Janeiro,25,1,1,0,acept,1750,46,23,1819
Belo Horizonte,68,3,2,1,acept,2250,95,30,2375
Sao Paulo,900,3,4,8,acept,20000,3813,301,24114
Porto Alegre,71,2,1,0,acept,990,0,15,1005
Rio de Janeiro,250,3,2,1,acept,6400,746,83,7229
Belo Horizonte,305,4,5,5,acept,14000,2239,187,16426
Sao Paulo,81,3,2,1,acept,1700,90,22,1812
Sao Paulo,234,3,4,4,acept,3600,1375,46,5021
Campinas,54,1,2,0,acept,720,46,10,776
Sao Paulo,70,2,1,1,not acept,4960,347,63,5370
Belo Horizonte,100,3,2,1,acept,1800,140,24,1964
Sao Paulo,48,1,1,1,acept,4200,135,54,4389
Porto Alegre,88,2,2,1,acept,1900,77,28,2005
Sao Paulo,40,1,1,0,acept,2000,53,31,2084
Porto Alegre,76,1,1,0,not acept,1490,177,22,1689
Sao Paulo,109,3,2,2,acept,6500,319,83,6902
Belo Horizonte,160,3,3,2,acept,2650,269,36,2955
Sao Paulo,106,2,1,0,acept,1790,0,23,1813
Rio de Janeiro,90,4,2,0,acept,1900,55,25,1980
Sao Paulo,70,2,2,1,acept,2000,0,26,2026
Sao Paulo,120,2,1,4,acept,2000,207,31,2238
Sao Paulo,230,3,3,3,acept,3916,586,50,4552
Sao Paulo,130,2,2,2,acept,3500,448,53,4001
Sao Paulo,67,2,2,1,acept,1970,205,25,2200
Campinas,140,4,3,2,acept,3500,220,45,3765
Rio de Janeiro,80,3,2,0,acept,1500,71,20,1591
Sao Paulo,40,1,1,0,acept,1350,0,18,1368
Belo Horizonte,49,2,1,1,acept,1000,0,14,1014
Sao Paulo,73,3,1,1,acept,3800,138,49,3987
Sao Paulo,110,2,3,3,acept,2200,8,34,2242
Sao Paulo,79,3,2,1,acept,2400,62,31,2493
Belo Horizonte,40,1,1,0,not acept,1155,55,16,1226
Sao Paulo,370,4,6,0,acept,7900,2386,101,10387
Belo Horizonte,140,4,3,2,acept,2200,132,30,2362
Rio de Janeiro,300,4,4,2,acept,8000,1275,104,9379
Sao Paulo,40,1,1,1,not acept,1635,0,21,1656
Rio de Janeiro,100,3,2,2,acept,1600,250,21,1871
Sao Paulo,63,2,2,1,acept,1890,9,24,1923
Sao Paulo,150,3,2,1,not acept,5500,0,70,5570
Sao Paulo,190,3,3,3,acept,13000,84,165,13249
Rio de Janeiro,100,3,2,2,acept,2400,395,31,2826
Porto Alegre,132,6,4,2,acept,3400,117,50,3567
Sao Paulo,127,2,3,3,acept,3300,500,42,3842
Sao Paulo,222,3,3,2,acept,2400,292,21,2713
Sao Paulo,80,2,2,1,acept,1680,9,26,1715
Sao Paulo,208,4,4,3,acept,12000,1084,153,13237
Sao Paulo,480,4,4,6,acept,10000,1000,151,11151
Sao Paulo,360,3,5,2,acept,15000,834,191,16025
Sao Paulo,142,3,2,2,acept,1750,243,23,2016
Rio de Janeiro,150,3,3,0,not acept,5100,242,66,5408
Rio de Janeiro,54,2,1,1,acept,1600,0,21,1621
Rio de Janeiro,35,1,1,0,acept,1000,0,13,1013
Campinas,44,2,1,1,acept,1090,10,14,1114
Sao Paulo,130,3,2,1,acept,4500,100,58,4658
Porto Alegre,70,2,2,0,not acept,1550,42,23,1615
Sao Paulo,68,2,1,0,acept,1300,0,17,1317
Sao Paulo,212,4,3,4,acept,15000,1272,191,16463
Rio de Janeiro,35,1,1,1,acept,3300,112,43,3455
Sao Paulo,116,3,2,1,acept,1700,90,22,1812
Sao Paulo,80,1,1,0,acept,1900,0,25,1925
Sao Paulo,47,1,1,1,acept,2250,114,29,2393
Rio de Janeiro,60,3,2,1,acept,1000,63,13,1076
Rio de Janeiro,75,2,1,0,acept,1200,0,16,1216
Belo Horizonte,60,1,1,1,acept,1098,151,15,1264
Sao Paulo,100,2,1,0,not acept,5000,125,76,5201
Belo Horizonte,22,1,1,1,not acept,1500,0,20,1520
Sao Paulo,75,3,2,1,not acept,2900,125,37,3062
Sao Paulo,75,2,3,2,not acept,2500,70,32,2602
Belo Horizonte,65,2,1,1,acept,700,0,10,710
Sao Paulo,25,1,1,0,acept,1300,22,17,1339
Sao Paulo,194,4,3,2,acept,2999,643,38,3680
Sao Paulo,75,2,2,0,acept,2000,109,31,2140
Belo Horizonte,51,2,1,0,acept,1000,27,14,1041
Sao Paulo,63,2,2,2,not acept,4080,167,52,4299
Rio de Janeiro,90,2,2,1,acept,1200,17,16,1233
Sao Paulo,45,2,1,1,not acept,3000,167,39,3206
Rio de Janeiro,85,2,2,1,acept,2000,82,26,2108
Rio de Janeiro,70,2,2,1,acept,1700,59,22,1781
Porto Alegre,66,2,1,0,acept,1700,59,25,1784
Rio de Janeiro,45,1,1,0,acept,1100,0,15,1115
Porto Alegre,114,3,2,1,acept,2900,109,43,3052
Rio de Janeiro,26,1,1,0,acept,2300,61,30,2391
Porto Alegre,60,1,1,2,acept,2000,0,30,2030
Porto Alegre,44,1,1,0,acept,1100,30,17,1147
Belo Horizonte,20,1,1,0,not acept,1050,79,14,1143
Sao Paulo,91,2,3,2,not acept,9800,500,125,10425
Rio de Janeiro,70,2,2,1,acept,1000,45,13,1058
Sao Paulo,30,1,1,0,acept,1550,21,20,1591
Belo Horizonte,308,4,5,4,acept,15000,167,200,15367
Sao Paulo,90,2,2,1,acept,3000,50,39,3089
Sao Paulo,217,3,5,6,acept,5000,417,76,5493
Campinas,47,1,1,0,acept,1700,72,22,1794
Rio de Janeiro,60,2,1,1,acept,1800,0,24,1824
Sao Paulo,35,1,1,0,not acept,1305,0,17,1322
Sao Paulo,490,3,5,4,acept,10000,2270,151,12421
Sao Paulo,180,3,3,2,not acept,3000,0,39,3039
Porto Alegre,65,2,2,2,acept,1950,41,29,2020
Porto Alegre,76,2,2,2,acept,1700,34,25,1759
Campinas,56,2,1,1,acept,1400,57,18,1475
Sao Paulo,68,1,1,0,acept,1500,0,20,1520
Campinas,56,1,1,1,acept,1350,50,18,1418
Rio de Janeiro,131,3,2,2,acept,10000,500,129,10629
Sao Paulo,100,3,1,4,acept,2500,226,38,2764
Sao Paulo,72,2,2,1,acept,2500,125,32,2657
Belo Horizonte,88,3,2,1,acept,1450,114,20,1584
Rio de Janeiro,38,1,1,0,acept,1850,150,24,2024
Sao Paulo,49,2,1,1,acept,1300,17,17,1334
Sao Paulo,60,1,1,1,acept,4600,100,59,4759
Sao Paulo,80,2,1,1,acept,2950,195,38,3183
Porto Alegre,280,5,3,3,acept,4000,117,72,4189
Sao Paulo,510,4,3,5,acept,10000,517,151,10668
Sao Paulo,148,1,2,4,acept,9900,550,126,10576
Porto Alegre,76,3,2,1,acept,1600,59,24,1683
Belo Horizonte,110,3,2,1,not acept,1400,150,19,1569
Belo Horizonte,22,1,1,1,not acept,1275,0,17,1292
Sao Paulo,42,1,1,1,acept,2000,88,26,2114
Sao Paulo,59,2,1,1,not acept,1700,0,22,1722
Sao Paulo,158,4,4,4,acept,2500,423,32,2955
Belo Horizonte,65,2,2,1,not acept,925,84,13,1022
Sao Paulo,20,1,1,0,acept,1800,130,23,1953
Sao Paulo,298,4,4,1,acept,3000,0,46,3046
Rio de Janeiro,38,1,1,0,not acept,2280,123,30,2433
Sao Paulo,213,4,4,3,acept,6500,1157,83,7740
Sao Paulo,150,3,2,3,acept,1900,125,29,2054
Rio de Janeiro,60,1,1,0,acept,1000,0,13,1013
Sao Paulo,65,2,1,1,acept,1400,84,18,1502
Sao Paulo,169,4,4,4,acept,6450,1140,82,7672
Sao Paulo,100,2,3,1,acept,3973,315,51,4339
Sao Paulo,158,4,4,3,acept,6600,375,84,7059
Sao Paulo,150,2,2,2,acept,6000,667,91,6758
Porto Alegre,49,2,1,0,acept,1650,15,25,1690
Sao Paulo,260,4,4,4,acept,5000,1417,64,6481
Rio de Janeiro,65,1,1,1,acept,2500,241,33,2774
Sao Paulo,380,6,5,3,not acept,9000,417,136,9553
Belo Horizonte,70,3,1,0,acept,1200,25,16,1241
Campinas,180,2,1,0,acept,2000,15,31,2046
Rio de Janeiro,105,2,1,0,acept,1250,55,17,1322
Belo Horizonte,300,8,3,1,acept,4000,500,66,4566
Sao Paulo,190,3,3,1,acept,9000,492,115,9607
Belo Horizonte,67,2,2,2,acept,1000,82,14,1096
Sao Paulo,96,2,2,2,not acept,9000,0,115,9115
Porto Alegre,75,2,2,1,acept,1300,250,19,1569
Campinas,45,1,1,1,acept,1100,34,14,1148
Sao Paulo,60,2,1,1,acept,1900,0,25,1925
Sao Paulo,45,1,1,1,not acept,2970,92,38,3100
Sao Paulo,38,1,1,1,not acept,3400,0,44,3444
Sao Paulo,75,1,1,1,not acept,1521,163,23,1707
Sao Paulo,442,5,6,6,acept,7500,1301,113,8914
Sao Paulo,220,3,3,2,not acept,11000,542,140,11682
Sao Paulo,140,3,1,2,not acept,6000,273,91,6364
Belo Horizonte,76,3,2,1,acept,1400,128,19,1547
Campinas,60,2,1,1,acept,580,15,8,603
Porto Alegre,50,1,1,0,acept,803,0,12,815
Sao Paulo,165,4,3,2,acept,5000,46,76,5122
Sao Paulo,90,1,1,0,not acept,1150,59,18,1227
Campinas,62,2,1,1,acept,1200,76,16,1292
Sao Paulo,120,3,2,2,acept,3800,0,58,3858
Belo Horizonte,279,4,5,4,acept,4500,379,74,4953
Rio de Janeiro,79,3,2,0,not acept,3500,183,46,3729
Rio de Janeiro,45,1,1,0,acept,980,0,13,993
Rio de Janeiro,36,1,1,0,acept,590,244,8,842
Campinas,47,1,1,0,not acept,750,0,10,760
Campinas,270,4,4,8,acept,3200,144,49,3393
Belo Horizonte,25,1,1,0,not acept,890,59,12,961
Sao Paulo,45,2,1,1,acept,1125,26,15,1166
Sao Paulo,255,4,4,3,acept,6600,1678,84,8362
Campinas,55,1,2,1,not acept,954,74,13,1041
Sao Paulo,85,3,3,2,not acept,4940,300,63,5303
Belo Horizonte,200,3,3,2,acept,2700,135,36,2871
Porto Alegre,55,2,2,0,acept,1400,34,21,1455
Sao Paulo,180,5,5,2,acept,2287,517,29,2833
Campinas,64,2,2,2,acept,1900,129,25,2054
Porto Alegre,42,2,1,1,acept,923,100,14,1037
Sao Paulo,300,3,3,5,acept,5400,834,82,6316
Sao Paulo,32,1,1,1,acept,2000,416,26,2442
Sao Paulo,64,2,1,2,acept,1850,39,24,1913
Sao Paulo,72,2,2,1,acept,1440,27,19,1486
Rio de Janeiro,30,1,1,0,not acept,1000,0,13,1013
Porto Alegre,55,2,1,0,acept,1250,85,19,1354
Sao Paulo,253,3,5,5,acept,6750,1770,86,8606
Sao Paulo,147,3,2,0,not acept,4250,0,54,4304
Sao Paulo,110,3,3,1,acept,4575,140,58,4773
Sao Paulo,400,4,3,4,acept,3760,2084,57,5901
Porto Alegre,350,5,4,2,acept,4794,500,86,5380
Sao Paulo,510,5,5,5,not acept,10000,2317,151,12468
Sao Paulo,246,3,4,4,acept,10000,1480,127,11607
Campinas,92,3,4,2,acept,2200,144,28,2372
Sao Paulo,54,2,2,1,not acept,2300,167,30,2497
Sao Paulo,130,3,2,0,acept,3700,350,47,4097
Rio de Janeiro,53,2,2,1,acept,1100,60,15,1175
Sao Paulo,59,2,1,1,acept,1500,0,20,1520
Belo Horizonte,153,3,2,2,acept,9876,196,162,10234
Sao Paulo,78,2,1,1,acept,950,32,13,995
Sao Paulo,305,3,3,3,acept,5500,2167,70,7737
Campinas,54,1,1,1,acept,1148,84,15,1247
Sao Paulo,80,2,2,0,acept,1275,113,17,1405
Sao Paulo,26,1,1,0,acept,1490,0,19,1509
Sao Paulo,96,2,1,1,not acept,2500,159,32,2691
Campinas,70,3,1,1,acept,1300,17,17,1334
Sao Paulo,56,2,1,1,acept,2500,0,32,2532
Belo Horizonte,320,5,3,4,acept,5500,219,91,5810
Sao Paulo,30,1,1,0,not acept,861,0,13,874
Rio de Janeiro,45,1,1,0,not acept,1000,0,13,1013
Campinas,60,2,1,0,acept,1134,55,15,1204
Sao Paulo,101,2,3,1,acept,3500,267,45,3812
Sao Paulo,220,4,4,2,acept,3200,552,41,3793
Sao Paulo,60,2,1,0,not acept,1200,44,19,1263
Sao Paulo,62,2,1,1,acept,1800,55,23,1878
Rio de Janeiro,65,2,1,1,acept,1100,0,15,1115
Porto Alegre,111,2,2,1,acept,1102,33,20,1155
Sao Paulo,140,2,1,2,acept,4000,821,61,4882
Sao Paulo,17,1,1,0,not acept,2100,50,27,2177
Sao Paulo,90,3,2,2,acept,3500,250,45,3795
Sao Paulo,40,1,1,0,not acept,1350,80,21,1451
Rio de Janeiro,70,2,2,0,not acept,6100,150,79,6329
Sao Paulo,370,4,5,5,acept,5000,1992,64,7056
Porto Alegre,48,2,1,1,acept,1000,7,15,1022
Belo Horizonte,130,3,2,1,acept,2500,122,34,2656
Sao Paulo,303,3,4,4,acept,18000,0,229,18229
Sao Paulo,150,3,4,3,acept,10740,67,137,10944
Sao Paulo,45,1,1,1,not acept,5520,0,70,5590
Belo Horizonte,190,4,4,3,not acept,6200,501,83,6784
Belo Horizonte,250,4,4,0,acept,3940,0,65,4005
Campinas,78,3,2,2,acept,1690,68,22,1780
Sao Paulo,160,3,3,2,acept,2500,7,38,2545
Rio de Janeiro,100,3,2,1,acept,1850,85,24,1959
Sao Paulo,298,3,4,3,acept,14700,1284,221,16205
Porto Alegre,140,3,3,1,acept,1500,59,27,1586
Sao Paulo,78,2,2,2,acept,4338,0,55,4393
Campinas,47,1,1,1,acept,650,0,9,659
Sao Paulo,80,2,1,2,acept,2424,245,31,2700
Sao Paulo,20,1,1,0,acept,1800,130,23,1953
Sao Paulo,60,2,1,1,acept,1550,0,20,1570
Rio de Janeiro,52,1,1,0,not acept,2500,117,33,2650
Belo Horizonte,75,3,1,1,acept,1100,61,15,1176
Sao Paulo,45,2,1,1,acept,2364,77,30,2471
Sao Paulo,26,1,1,0,not acept,900,10,12,922
Belo Horizonte,120,3,2,0,acept,2200,76,37,2313
Sao Paulo,239,4,4,4,acept,5500,974,70,6544
Sao Paulo,22,1,1,1,not acept,2200,0,28,2228
Sao Paulo,750,7,6,5,acept,5800,559,88,6447
Rio de Janeiro,148,3,2,2,acept,4000,279,52,4331
Rio de Janeiro,80,2,1,0,not acept,1000,98,13,1111
Sao Paulo,76,3,1,2,acept,2280,270,29,2579
Sao Paulo,45,1,1,1,acept,3200,105,41,3346
Campinas,74,3,2,1,acept,1600,250,21,1871
Porto Alegre,38,1,1,1,acept,500,6,8,514
Sao Paulo,57,1,1,0,acept,6000,17,77,6094
Sao Paulo,40,1,1,0,not acept,780,17,12,809
Sao Paulo,147,3,3,2,acept,2200,513,28,2741
Sao Paulo,300,4,5,2,acept,7800,609,99,8508
Sao Paulo,50,2,1,1,acept,1200,72,16,1288
Porto Alegre,55,1,1,1,not acept,3500,104,52,3656
Rio de Janeiro,25,1,1,0,acept,1400,26,19,1445
Sao Paulo,80,3,2,2,acept,3650,90,47,3787
Belo Horizonte,300,2,4,3,acept,2800,667,38,3505
Sao Paulo,680,4,5,8,acept,8000,217,121,8338
Sao Paulo,252,4,5,5,acept,12500,1750,159,14409
Sao Paulo,208,3,3,2,acept,7000,552,89,7641
Rio de Janeiro,36,1,1,0,acept,750,51,10,811
Belo Horizonte,50,2,1,1,acept,1100,28,15,1143
Rio de Janeiro,70,1,2,0,not acept,1200,0,19,1219
Belo Horizonte,184,5,3,2,acept,2600,171,35,2806
Sao Paulo,100,2,2,2,acept,5590,280,85,5955
Porto Alegre,73,2,1,0,acept,1350,25,20,1395
Rio de Janeiro,140,3,2,1,acept,1290,330,17,1637
Rio de Janeiro,240,3,2,1,acept,8000,459,104,8563
Sao Paulo,60,2,1,1,acept,2700,0,35,2735
Sao Paulo,170,3,3,2,acept,4500,503,58,5061
Porto Alegre,59,2,1,1,acept,1930,50,29,2009
Rio de Janeiro,169,3,2,1,acept,2700,308,35,3043
Campinas,58,1,2,2,acept,1235,80,16,1331
Campinas,110,2,1,1,acept,980,52,13,1045
Sao Paulo,70,2,2,0,not acept,1500,0,23,1523
Porto Alegre,27,1,1,0,acept,960,75,15,1050
Sao Paulo,200,3,2,3,acept,4000,0,51,4051
Rio de Janeiro,180,3,2,2,not acept,7000,100,91,7191
Sao Paulo,33,1,1,1,not acept,1000,100,13,1113
Sao Paulo,120,2,3,0,acept,7000,450,106,7556
Porto Alegre,47,1,1,1,not acept,2200,0,33,2233
Sao Paulo,470,5,4,6,acept,7200,667,109,7976
Campinas,277,3,4,4,acept,3170,28,48,3246
Rio de Janeiro,71,3,2,0,not acept,1450,8,19,1477
Sao Paulo,40,1,1,1,acept,1200,0,19,1219
Sao Paulo,90,2,1,0,not acept,3850,130,49,4029
Sao Paulo,244,3,4,2,acept,4500,535,68,5103
Campinas,55,1,1,1,acept,1100,0,14,1114
Campinas,92,3,2,2,acept,3200,139,41,3380
Sao Paulo,318,5,3,2,acept,3840,600,58,4498
Rio de Janeiro,74,3,1,0,acept,1600,40,25,1665
Sao Paulo,60,2,2,1,acept,2200,49,28,2277
Belo Horizonte,120,3,3,1,acept,2300,173,31,2504
Sao Paulo,30,1,1,1,not acept,1950,229,25,2204
Sao Paulo,55,1,1,1,acept,5000,375,64,5439
Porto Alegre,38,1,1,0,acept,770,38,12,820
Porto Alegre,55,3,1,0,not acept,720,8,13,741
Sao Paulo,182,3,2,1,acept,9000,283,115,9398
Rio de Janeiro,77,2,2,1,acept,1950,137,26,2113
Campinas,160,3,1,4,not acept,3400,135,52,3587
Sao Paulo,346,4,4,4,acept,4080,2704,52,6836
Rio de Janeiro,80,2,1,0,acept,1300,220,17,1537
Campinas,88,3,2,2,acept,1950,104,25,2079
Rio de Janeiro,75,2,2,1,acept,2500,273,33,2806
Rio de Janeiro,120,3,2,0,acept,3500,259,46,3805
Rio de Janeiro,28,1,1,0,acept,1230,50,16,1296
Sao Paulo,29,1,1,0,acept,2000,5,26,2031
Belo Horizonte,67,3,1,1,acept,900,70,12,982
Sao Paulo,110,3,2,1,not acept,6500,193,83,6776
Sao Paulo,170,3,2,1,acept,5500,415,70,5985
Sao Paulo,80,2,2,1,not acept,1500,75,23,1598
Sao Paulo,72,2,1,1,acept,1440,0,19,1459
Belo Horizonte,76,1,2,2,acept,4000,354,54,4408
Rio de Janeiro,126,2,2,1,acept,3500,312,46,3858
Sao Paulo,150,1,2,2,acept,5500,300,70,5870
Rio de Janeiro,40,1,1,0,acept,1505,25,20,1550
Sao Paulo,84,3,2,3,not acept,3200,413,41,3654
Rio de Janeiro,100,4,4,1,acept,4350,0,57,4407
Sao Paulo,209,3,3,0,acept,4000,803,51,4854
Belo Horizonte,100,3,2,1,acept,1400,119,19,1538
Sao Paulo,50,2,1,1,acept,1300,0,17,1317
Campinas,110,3,3,2,acept,3200,88,49,3337
Rio de Janeiro,23,1,1,0,not acept,1500,0,20,1520
Sao Paulo,50,1,1,0,not acept,1200,84,19,1303
Sao Paulo,68,1,2,1,acept,4500,100,58,4658
Porto Alegre,86,2,1,0,acept,1150,58,21,1229
Sao Paulo,57,2,2,1,acept,1150,10,15,1175
Belo Horizonte,110,2,2,1,acept,4000,84,54,4138
Sao Paulo,69,2,1,1,acept,1550,70,20,1640
Campinas,48,1,1,1,not acept,550,42,7,599
Sao Paulo,240,3,5,3,acept,10800,1250,137,12187
Belo Horizonte,84,3,2,0,acept,1250,130,17,1397
Sao Paulo,88,2,2,3,acept,3400,463,44,3907
Sao Paulo,270,3,2,2,acept,10000,407,127,10534
Rio de Janeiro,66,2,1,1,acept,1560,88,21,1669
Rio de Janeiro,81,3,1,1,acept,1500,49,20,1569
Sao Paulo,184,4,3,3,acept,4500,750,58,5308
Sao Paulo,170,3,2,2,not acept,3000,50,46,3096
Sao Paulo,500,3,5,2,acept,15000,1000,191,16191
Sao Paulo,200,3,4,3,acept,6200,1084,79,7363
Sao Paulo,70,2,2,1,acept,1900,25,25,1950
Belo Horizonte,155,4,5,3,acept,6200,542,83,6825
Sao Paulo,100,3,1,0,acept,2650,0,34,2684
Sao Paulo,198,1,1,3,not acept,10700,350,136,11186
Sao Paulo,45,2,1,0,not acept,2800,0,36,2836
Sao Paulo,40,1,1,1,not acept,4800,350,61,5211
Porto Alegre,30,1,1,0,acept,1100,42,17,1159
Sao Paulo,44,1,1,1,acept,2572,91,33,2696
Sao Paulo,98,3,2,2,not acept,4300,180,55,4535
Belo Horizonte,73,3,1,0,acept,900,38,12,950
Sao Paulo,340,4,4,4,acept,8700,0,111,8811
Porto Alegre,101,3,2,0,acept,1920,87,29,2036
Rio de Janeiro,30,1,1,0,acept,1720,0,23,1743
Sao Paulo,80,1,1,0,acept,1600,60,25,1685
Rio de Janeiro,30,1,1,1,acept,500,0,7,507
Sao Paulo,999,4,5,6,acept,15000,2500,226,17726
Sao Paulo,171,3,5,3,acept,10600,870,135,11605
Sao Paulo,100,3,2,1,acept,1600,90,21,1711
Sao Paulo,70,2,1,1,acept,2707,0,11,2718
Sao Paulo,49,1,1,0,acept,2600,66,33,2699
Belo Horizonte,62,2,2,0,acept,1300,0,18,1318
Sao Paulo,162,4,5,3,acept,3700,525,47,4272
Sao Paulo,260,4,4,4,acept,15000,1589,191,16780
Rio de Janeiro,266,4,4,2,acept,4850,659,63,5572
Sao Paulo,250,3,5,5,acept,15000,1834,191,17025
Sao Paulo,124,3,3,2,not acept,2500,430,32,2962
Belo Horizonte,57,3,1,1,acept,900,56,12,968
Sao Paulo,218,3,4,2,not acept,7800,334,99,8233
Sao Paulo,210,4,4,4,acept,13100,1325,166,14591
Porto Alegre,274,3,2,2,acept,2500,253,37,2790
Sao Paulo,52,2,2,1,acept,1800,0,23,1823
Sao Paulo,254,4,6,5,not acept,7740,1584,99,9423
Sao Paulo,147,3,3,3,acept,3600,309,46,3955
Rio de Janeiro,78,2,2,1,acept,1650,0,26,1676
Sao Paulo,60,2,2,0,acept,1300,170,10,1480
Rio de Janeiro,130,3,2,0,acept,2700,300,35,3035
Sao Paulo,50,1,1,1,acept,2700,105,35,2840
Sao Paulo,110,3,2,3,acept,2600,334,33,2967
Rio de Janeiro,80,2,1,0,acept,2850,173,37,3060
Sao Paulo,376,5,6,4,acept,12000,1980,153,14133
Sao Paulo,50,2,1,0,acept,1370,7,18,1395
Sao Paulo,179,3,2,2,acept,10000,443,127,10570
Campinas,163,3,5,3,acept,9800,350,125,10275
Rio de Janeiro,110,3,1,1,acept,1820,124,24,1968
Sao Paulo,330,6,4,3,acept,13000,1156,196,14352
Sao Paulo,35,1,1,0,acept,1850,0,24,1874
Campinas,96,3,3,2,not acept,4147,243,53,4443
Belo Horizonte,90,2,3,0,acept,2080,9,35,2124
Sao Paulo,45,1,1,0,acept,1500,76,23,1599
Sao Paulo,130,3,1,1,acept,5600,0,85,5685
Rio de Janeiro,77,2,1,0,acept,1200,59,16,1275
Sao Paulo,35,1,1,1,acept,2650,127,34,2811
Sao Paulo,280,3,4,4,not acept,12000,1150,153,13303
Sao Paulo,24606,5,4,4,acept,8100,7859,103,16062
Belo Horizonte,344,4,4,3,not acept,3500,121,58,3679
Belo Horizonte,140,4,2,2,acept,1950,271,26,2247
Belo Horizonte,95,3,4,1,acept,3000,254,40,3294
Campinas,55,2,1,1,acept,900,34,12,946
Campinas,54,1,2,0,acept,720,46,10,776
Belo Horizonte,50,2,1,2,acept,850,109,12,971
Sao Paulo,200,4,5,4,acept,10000,1150,127,11277
Sao Paulo,50,1,1,1,acept,2350,24,30,2404
Sao Paulo,200,4,2,3,acept,4500,0,68,4568
Sao Paulo,67,2,2,1,acept,2840,255,36,3131
Sao Paulo,62,3,2,1,not acept,2050,0,26,2076
Rio de Janeiro,50,1,1,0,acept,1700,77,22,1799
Porto Alegre,77,2,2,2,acept,2500,0,37,2537
Sao Paulo,220,3,3,2,acept,4680,184,60,4924
Sao Paulo,253,4,5,3,acept,4100,0,52,4152
Sao Paulo,500,4,4,3,acept,9000,0,136,9136
Sao Paulo,35,1,1,0,acept,900,0,12,912
Sao Paulo,23,1,1,1,acept,2300,59,30,2389
Sao Paulo,325,4,3,2,acept,8500,1111,108,9719
Porto Alegre,28,1,1,0,acept,800,15,12,827
Rio de Janeiro,76,2,2,1,acept,3360,203,44,3607
Sao Paulo,70,2,1,1,acept,1300,48,17,1365
Sao Paulo,120,3,4,2,acept,2040,667,26,2733
Rio de Janeiro,180,3,3,0,acept,2500,170,39,2709
Sao Paulo,350,4,3,4,acept,6000,743,91,6834
Porto Alegre,60,1,1,0,acept,750,42,11,803
Porto Alegre,87,2,2,2,acept,2900,67,43,3010
Sao Paulo,80,3,1,0,not acept,2837,342,36,3215
Sao Paulo,90,3,1,0,acept,2700,66,41,2807
Sao Paulo,200,4,3,8,acept,8700,1917,131,10748
Sao Paulo,260,4,4,3,acept,15000,1500,191,16691
Rio de Janeiro,100,3,1,2,acept,4500,213,58,4771
Sao Paulo,50,2,2,0,not acept,950,0,13,963
Sao Paulo,800,4,7,8,acept,12000,1667,181,13848
Sao Paulo,75,1,2,2,acept,2500,321,32,2853
Sao Paulo,213,3,2,0,acept,4100,230,52,4382
Sao Paulo,70,2,2,1,acept,1650,102,25,1777
Porto Alegre,55,2,1,0,acept,1000,42,15,1057
Sao Paulo,264,3,3,2,acept,5300,665,68,6033
Belo Horizonte,66,2,1,1,not acept,1650,83,22,1755
Campinas,269,4,5,0,acept,5100,963,65,6128
Rio de Janeiro,50,2,1,1,acept,1550,13,20,1583
Sao Paulo,400,4,5,5,acept,10000,1896,151,12047
Sao Paulo,38,1,1,0,not acept,1685,30,22,1737
Rio de Janeiro,50,2,1,0,acept,1800,50,24,1874
Sao Paulo,84,1,1,1,not acept,2500,246,32,2778
Campinas,40,1,1,1,not acept,1000,33,13,1046
Sao Paulo,50,1,1,0,not acept,690,0,11,701
Porto Alegre,27,1,1,0,acept,960,75,15,1050
Sao Paulo,90,2,2,0,acept,3200,0,41,3241
Porto Alegre,50,1,1,0,not acept,1500,50,22,1572
Sao Paulo,220,3,4,1,acept,12000,334,153,12487
Sao Paulo,106,3,3,1,acept,2500,350,32,2882
Sao Paulo,65,2,1,2,acept,1800,167,23,1990
Porto Alegre,70,2,1,1,acept,930,45,14,989
Sao Paulo,260,2,3,4,acept,5500,142,83,5725
Campinas,60,2,1,1,acept,820,16,11,847
Rio de Janeiro,80,2,2,0,acept,1275,0,17,1292
Sao Paulo,132,3,2,3,acept,2500,59,38,2597
Sao Paulo,85,2,2,2,not acept,7200,417,92,7709
Sao Paulo,600,4,6,6,acept,12000,2592,181,14773
Sao Paulo,87,2,2,1,acept,2975,117,38,3130
Sao Paulo,78,3,1,2,acept,2330,150,30,2510
Sao Paulo,188,3,3,3,acept,8000,841,102,8943
Rio de Janeiro,38,1,1,1,acept,1450,0,19,1469
Sao Paulo,209,4,4,5,acept,9800,0,125,9925
Sao Paulo,280,4,5,4,acept,13000,1000,165,14165
Sao Paulo,420,4,4,4,acept,15000,3334,191,18525
Belo Horizonte,68,2,1,0,acept,1000,0,17,1017
Porto Alegre,46,1,1,0,acept,990,30,15,1035
Porto Alegre,63,2,1,2,acept,2750,92,41,2883
Sao Paulo,220,3,3,3,acept,3700,324,56,4080
Sao Paulo,150,3,4,2,acept,3000,42,46,3088
Sao Paulo,98,2,2,2,acept,8500,450,108,9058
Rio de Janeiro,119,3,3,2,acept,3000,129,39,3168
Porto Alegre,40,1,1,0,not acept,796,26,12,834
Porto Alegre,110,3,1,1,acept,2700,83,40,2823
Sao Paulo,50,2,3,0,not acept,1740,84,27,1851
Sao Paulo,25,1,1,0,acept,2200,45,28,2273
Sao Paulo,75,2,1,1,not acept,2000,0,26,2026
Sao Paulo,50,2,1,1,not acept,1500,0,20,1520
Rio de Janeiro,152,4,2,1,acept,3500,357,46,3903
Sao Paulo,330,4,2,8,not acept,4000,388,61,4449
Sao Paulo,251,3,2,2,acept,3400,336,52,3788
Rio de Janeiro,120,3,3,2,acept,3000,504,39,3543
Sao Paulo,64,1,2,2,acept,2100,92,27,2219
Porto Alegre,180,3,2,1,not acept,2000,125,30,2155
Belo Horizonte,61,3,1,1,acept,1500,85,20,1605
Campinas,62,2,1,0,acept,800,25,11,836
Sao Paulo,35,1,1,1,not acept,3388,124,43,3555
Belo Horizonte,60,2,1,1,acept,1300,30,18,1348
Porto Alegre,58,1,2,2,acept,2200,0,33,2233
Sao Paulo,146,3,5,2,acept,6600,424,84,7108
Sao Paulo,176,3,4,3,acept,6500,775,83,7358
Sao Paulo,220,6,2,2,acept,3600,125,55,3780
Belo Horizonte,47,2,1,1,not acept,1300,0,18,1318
Sao Paulo,30,1,1,0,not acept,650,38,9,697
Sao Paulo,103,3,2,0,acept,2160,39,28,2227
Rio de Janeiro,600,7,6,2,not acept,9000,1084,138,10222
Rio de Janeiro,200,4,5,3,acept,6200,155,95,6450
Sao Paulo,34,1,1,0,acept,1530,25,20,1575
Sao Paulo,95,2,1,1,acept,2900,0,44,2944
Sao Paulo,215,4,4,2,not acept,6000,917,77,6994
Rio de Janeiro,60,2,1,1,not acept,1230,88,16,1334
Rio de Janeiro,145,3,2,1,acept,9000,700,116,9816
Sao Paulo,102,3,2,2,acept,1600,0,25,1625
Sao Paulo,44,1,1,1,acept,3600,125,46,3771
Sao Paulo,90,2,2,0,acept,4200,250,54,4504
Sao Paulo,180,4,3,1,acept,5000,240,64,5304
Porto Alegre,123,3,3,1,not acept,3000,0,44,3044
Sao Paulo,54,2,2,1,not acept,2200,216,28,2444
Sao Paulo,50,1,1,1,acept,1884,0,11,1895
Sao Paulo,100,2,1,1,acept,1690,84,26,1800
Porto Alegre,36,1,1,1,acept,1200,35,18,1253
Sao Paulo,92,1,2,1,acept,3010,16,39,3065
Sao Paulo,68,2,2,1,acept,2000,79,26,2105
Sao Paulo,94,3,3,3,acept,4450,330,57,4837
Rio de Janeiro,25,1,1,0,acept,700,0,10,710
Sao Paulo,60,2,2,0,acept,1300,0,20,1320
Sao Paulo,321,5,3,5,acept,13000,2250,196,15446
Sao Paulo,116,3,4,2,acept,3900,413,50,4363
Sao Paulo,40,1,1,0,not acept,1010,0,16,1026
Porto Alegre,100,3,2,2,acept,2300,84,41,2425
Sao Paulo,70,2,1,0,acept,1300,163,20,1483
Sao Paulo,48,1,1,1,acept,1700,71,22,1793
Sao Paulo,115,3,5,2,acept,7000,495,89,7584
Sao Paulo,90,1,1,1,acept,3600,73,14,3687
Rio de Janeiro,89,2,2,1,acept,2900,148,38,3086
Porto Alegre,30,1,1,0,acept,1360,24,20,1404
Porto Alegre,39,1,1,0,acept,600,13,9,622
Sao Paulo,42,1,1,1,not acept,5250,100,67,5417
Sao Paulo,400,4,5,5,acept,7200,350,109,7659
Sao Paulo,47,1,2,1,acept,2500,125,32,2657
Sao Paulo,124,2,2,2,acept,7200,94,109,7403
Campinas,120,3,2,3,acept,2200,180,34,2414
Campinas,45,1,1,0,not acept,700,25,11,736
Sao Paulo,270,3,2,4,acept,6500,1167,98,7765
Sao Paulo,108,3,2,1,acept,3655,240,47,3942
Sao Paulo,128,3,4,4,not acept,8000,595,102,8697
Rio de Janeiro,179,4,2,0,acept,3040,484,40,3564
Belo Horizonte,140,4,2,2,acept,2000,237,27,2264
Belo Horizonte,27,1,1,0,not acept,1167,334,16,1517
Sao Paulo,250,3,4,2,acept,6000,517,77,6594
Porto Alegre,350,4,3,3,acept,4400,209,79,4688
Sao Paulo,208,3,2,2,acept,5000,500,64,5564
Sao Paulo,80,3,1,0,not acept,2100,0,27,2127
Sao Paulo,34,1,1,1,acept,3100,45,40,3185
Sao Paulo,150,4,3,0,acept,2850,275,37,3162
Sao Paulo,127,3,3,2,not acept,7000,421,89,7510
Sao Paulo,296,4,5,2,acept,8500,1000,128,9628
Sao Paulo,61,1,1,0,not acept,2700,0,35,2735
Sao Paulo,375,4,4,3,acept,9000,917,115,10032
Sao Paulo,370,5,4,3,acept,14000,1290,211,15501
Porto Alegre,30,1,1,0,acept,1270,42,19,1331
Sao Paulo,480,5,7,5,acept,8500,3700,108,12308
Sao Paulo,33,1,1,1,not acept,3500,0,45,3545
Rio de Janeiro,84,3,1,0,not acept,3100,209,40,3349
Sao Paulo,340,8,5,4,acept,7000,1400,106,8506
Porto Alegre,97,3,3,3,acept,3000,164,44,3208
Rio de Janeiro,110,3,2,1,acept,2500,190,33,2723
Belo Horizonte,77,3,3,2,acept,2200,306,30,2536
Rio de Janeiro,105,3,2,1,acept,2500,258,33,2791
Sao Paulo,33,1,1,1,not acept,1800,90,23,1913
Sao Paulo,25,1,1,0,acept,2040,0,26,2066
Sao Paulo,130,2,2,2,acept,4400,92,67,4559
Sao Paulo,480,4,7,5,acept,7500,1250,113,8863
Sao Paulo,240,3,3,3,acept,10000,1200,127,11327
Rio de Janeiro,80,2,2,1,acept,2500,300,33,2833
Sao Paulo,50,2,1,2,not acept,1900,42,25,1967
Belo Horizonte,32,1,1,0,not acept,1000,100,14,1114
Belo Horizonte,48,2,1,1,acept,1400,12,19,1431
Sao Paulo,90,3,3,1,acept,2600,11,40,2651
Rio de Janeiro,30,1,1,0,acept,1100,133,15,1248
Porto Alegre,75,2,2,1,acept,2800,135,41,2976
Porto Alegre,59,2,2,1,acept,1450,48,22,1520
Sao Paulo,25,1,1,0,not acept,1750,0,23,1773
Campinas,140,4,3,2,acept,3000,250,39,3289
Sao Paulo,100,2,1,1,acept,4000,120,51,4171
Campinas,23,1,1,0,not acept,990,0,13,1003
Sao Paulo,124,3,2,1,not acept,2750,289,35,3074
Sao Paulo,84,2,3,2,not acept,8500,450,108,9058
Sao Paulo,69,2,2,1,acept,4000,146,51,4197
Belo Horizonte,100,3,1,0,acept,2000,216,33,2249
Sao Paulo,70,1,2,1,acept,4000,106,51,4157
Belo Horizonte,88,3,2,1,acept,1290,0,18,1308
Belo Horizonte,465,7,7,2,acept,15000,435,246,15681
Sao Paulo,90,3,2,2,acept,2730,334,35,3099
Sao Paulo,120,3,3,1,acept,3000,189,39,3228
Sao Paulo,277,3,4,2,acept,7650,784,97,8531
Sao Paulo,270,4,6,3,acept,5000,669,76,5745
Porto Alegre,216,3,2,1,acept,3800,167,56,4023
Campinas,150,1,2,0,acept,1200,0,19,1219
Sao Paulo,360,4,7,5,acept,3995,2504,51,6550
Belo Horizonte,110,2,4,2,acept,2700,213,36,2949
Porto Alegre,50,2,1,1,acept,1300,16,19,1335
Sao Paulo,98,2,2,2,acept,7500,400,96,7996
Sao Paulo,190,3,3,3,not acept,5000,667,64,5731
Sao Paulo,35,1,1,1,acept,2500,90,32,2622
Sao Paulo,350,3,5,3,acept,12000,1250,181,13431
Belo Horizonte,950,6,6,2,acept,10000,1375,164,11539
Sao Paulo,213,4,5,4,acept,9900,1084,126,11110
Rio de Janeiro,100,3,2,1,not acept,3000,190,39,3229
Sao Paulo,240,4,4,4,acept,16000,1667,203,17870
Belo Horizonte,77,2,1,1,acept,960,129,13,1102
Sao Paulo,217,3,4,4,acept,14500,910,184,15594
Sao Paulo,218,4,4,3,acept,8400,1105,107,9612
Sao Paulo,31,2,1,0,acept,1040,0,14,1054
Sao Paulo,380,4,7,7,acept,15000,2500,191,17691
Rio de Janeiro,40,1,2,0,acept,1800,53,24,1877
Sao Paulo,48,1,1,1,acept,3800,150,49,3999
Sao Paulo,55,1,1,0,acept,1400,138,22,1560
Sao Paulo,270,3,3,3,acept,5740,834,87,6661
Rio de Janeiro,80,2,3,1,acept,4500,0,58,4558
Rio de Janeiro,50,1,1,0,acept,1850,0,24,1874
Sao Paulo,38,2,1,0,acept,3200,50,41,3291
Belo Horizonte,320,4,5,4,not acept,5000,940,67,6007
Sao Paulo,500,3,6,0,acept,6400,1667,97,8164
Rio de Janeiro,110,3,3,0,acept,2400,57,37,2494
Sao Paulo,300,3,3,2,acept,10500,768,158,11426
Sao Paulo,30,1,1,0,not acept,650,25,10,685
Sao Paulo,58,2,2,1,not acept,3400,71,44,3515
Sao Paulo,18,1,1,0,acept,1720,0,22,1742
Sao Paulo,139,4,4,8,acept,3500,265,53,3818
Rio de Janeiro,210,4,5,2,acept,8000,850,104,8954
Porto Alegre,50,2,1,1,acept,1180,0,18,1198
Sao Paulo,70,1,1,2,acept,7000,542,89,7631
Sao Paulo,36,1,1,0,acept,1275,0,5,1280
Sao Paulo,48,1,1,0,acept,1100,0,14,1114
Belo Horizonte,92,3,2,1,acept,1600,0,22,1622
Rio de Janeiro,189,3,2,0,acept,4500,452,58,5010
Porto Alegre,38,1,1,1,acept,2500,42,37,2579
Sao Paulo,351,3,4,2,not acept,9500,1192,121,10813
Rio de Janeiro,64,2,1,1,acept,2700,120,35,2855
Sao Paulo,31,1,1,1,acept,2400,75,31,2506
Sao Paulo,90,3,2,2,acept,2450,117,32,2599
Sao Paulo,40,1,1,0,acept,3463,0,32,3495
Sao Paulo,180,3,4,4,acept,15000,1417,191,16608
Sao Paulo,64,3,1,1,acept,1500,53,20,1573
Sao Paulo,190,3,4,3,acept,5500,525,70,6095
Sao Paulo,400,3,3,4,acept,14000,300,211,14511
Rio de Janeiro,180,4,5,3,acept,10000,725,129,10854
Sao Paulo,73,1,1,0,acept,3000,57,39,3096
Sao Paulo,64,2,2,2,acept,2600,75,33,2708
Sao Paulo,65,3,1,1,acept,2530,90,33,2653
Sao Paulo,400,4,5,4,acept,12800,1345,163,14308
Sao Paulo,48,2,1,1,not acept,5470,8,70,5548
Sao Paulo,40,1,1,1,not acept,1700,20,22,1742
Porto Alegre,61,2,1,0,not acept,1445,0,22,1467
Rio de Janeiro,85,2,1,0,acept,1700,58,22,1780
Belo Horizonte,235,4,3,1,acept,12000,563,197,12760
Sao Paulo,347,4,5,4,acept,12000,1500,153,13653
Rio de Janeiro,25,1,1,0,acept,540,0,7,547
Rio de Janeiro,85,2,2,1,acept,3600,363,47,4010
Sao Paulo,103,3,3,2,acept,6500,448,83,7031
Sao Paulo,159,3,3,2,not acept,3300,225,50,3575
Sao Paulo,42,1,1,1,acept,3600,125,46,3771
Sao Paulo,100,3,2,1,acept,1946,0,7,1953
Sao Paulo,111,1,2,2,acept,8000,466,102,8568
Porto Alegre,40,1,1,1,acept,1500,23,22,1545
Campinas,92,3,2,3,acept,2525,0,32,2557
Rio de Janeiro,480,5,6,4,acept,8000,1600,104,9704
Belo Horizonte,55,2,2,2,acept,2000,177,27,2204
Belo Horizonte,24,1,1,1,not acept,1200,0,16,1216
Sao Paulo,50,1,1,1,not acept,1000,0,16,1016
Rio de Janeiro,80,2,1,0,acept,1600,158,21,1779
Sao Paulo,230,3,2,0,acept,2500,500,32,3032
Porto Alegre,72,2,1,0,acept,1200,67,18,1285
Porto Alegre,90,2,1,0,acept,1353,77,20,1450
Belo Horizonte,22,1,1,0,not acept,700,0,10,710
Sao Paulo,455,4,5,4,acept,19500,3334,248,23082
Sao Paulo,140,3,2,1,not acept,2400,340,31,2771
Belo Horizonte,23,1,1,1,acept,1300,132,18,1450
Porto Alegre,46,1,1,0,acept,1070,56,16,1142
Campinas,70,1,1,1,acept,2350,6,30,2386
Belo Horizonte,150,5,3,0,acept,3250,100,54,3404
Campinas,55,1,1,0,acept,500,17,7,524
Sao Paulo,40,1,1,0,not acept,2040,70,31,2141
Sao Paulo,91,2,1,1,acept,1750,90,23,1863
Sao Paulo,140,2,1,3,acept,2500,194,38,2732
Sao Paulo,50,1,1,0,acept,1300,0,17,1317
Campinas,52,2,1,1,acept,980,77,13,1070
Rio de Janeiro,100,3,1,1,acept,3000,250,39,3289
Sao Paulo,160,4,3,3,acept,7000,542,89,7631
Sao Paulo,50,1,1,0,not acept,750,0,12,762
Campinas,137,3,2,1,acept,1800,250,23,2073
Porto Alegre,42,1,1,0,acept,1200,27,18,1245
Sao Paulo,650,3,7,2,acept,9900,600,149,10649
Rio de Janeiro,90,3,2,0,not acept,2000,0,31,2031
Rio de Janeiro,30,1,1,0,acept,1854,0,11,1865
Sao Paulo,254,4,4,3,acept,6780,478,86,7344
Sao Paulo,40,1,1,1,not acept,3600,180,46,3826
Rio de Janeiro,130,4,2,1,not acept,3300,145,43,3488
Campinas,128,3,3,2,acept,2650,682,34,3366
Sao Paulo,78,2,1,3,acept,1600,163,25,1788
Campinas,42,1,1,0,acept,690,12,9,711
Campinas,140,3,3,2,acept,2370,0,31,2401
Sao Paulo,46,1,1,0,acept,1600,0,21,1621
Campinas,50,2,1,1,acept,1170,0,15,1185
Sao Paulo,54,1,1,1,not acept,4130,250,53,4433
Sao Paulo,40,1,1,1,acept,3200,95,41,3336
Sao Paulo,50,2,1,1,acept,1100,0,14,1114
Sao Paulo,75,3,1,1,not acept,1800,0,23,1823
Sao Paulo,472,3,2,4,acept,6500,650,98,7248
Porto Alegre,360,5,3,6,acept,4800,197,86,5083
Sao Paulo,308,4,4,3,acept,15000,1917,191,17108
Sao Paulo,50,1,1,1,not acept,3700,209,47,3956
Sao Paulo,540,4,5,5,acept,5100,2236,65,7401
Sao Paulo,321,3,5,2,acept,7318,1072,111,8501
Sao Paulo,70,3,2,1,acept,1290,92,17,1399
Campinas,130,3,2,2,acept,2800,184,36,3020
Sao Paulo,170,3,2,2,acept,4500,267,68,4835
Sao Paulo,60,2,2,1,not acept,5500,150,70,5720
Rio de Janeiro,45,1,1,0,not acept,4500,80,58,4638
Belo Horizonte,60,2,1,1,acept,750,78,10,838
Sao Paulo,340,5,4,2,acept,12000,1000,153,13153
Porto Alegre,58,2,1,0,acept,750,30,11,791
Sao Paulo,195,4,3,3,not acept,10000,1336,127,11463
Sao Paulo,100,2,4,0,acept,3000,0,39,3039
Sao Paulo,50,1,1,0,acept,700,67,11,778
Campinas,54,2,1,1,acept,999,23,13,1035
Belo Horizonte,55,2,1,1,acept,1300,85,18,1403
Sao Paulo,48,1,1,2,acept,3550,486,45,4081
Sao Paulo,58,2,1,1,acept,1700,165,22,1887
Sao Paulo,200,3,4,3,acept,8500,1000,33,9533
Campinas,77,3,1,2,acept,1500,49,20,1569
Belo Horizonte,72,2,1,1,acept,1200,83,16,1299
Sao Paulo,50,2,1,2,not acept,1800,59,23,1882
Rio de Janeiro,95,2,2,1,acept,3000,28120,39,31159
Sao Paulo,130,3,2,0,acept,4800,215,61,5076
Rio de Janeiro,30,1,1,0,not acept,700,0,10,710
Sao Paulo,300,4,3,4,acept,15000,0,191,15191
Rio de Janeiro,95,3,2,1,acept,2245,268,29,2542
Sao Paulo,80,3,1,1,acept,1750,0,23,1773
Sao Paulo,310,3,3,2,not acept,15000,846,191,16037
Porto Alegre,170,3,2,0,acept,1000,165,15,1180
Rio de Janeiro,46,2,1,0,not acept,820,0,11,831
Rio de Janeiro,97,3,2,0,acept,2734,270,36,3040
Sao Paulo,130,3,2,1,not acept,7900,386,101,8387
Rio de Janeiro,30,1,1,0,not acept,1140,0,15,1155
Sao Paulo,40,1,1,1,not acept,2600,96,35,2731
Sao Paulo,90,3,2,2,not acept,2100,150,27,2277
Sao Paulo,89,2,2,2,acept,7700,351,98,8149
Sao Paulo,240,3,3,5,acept,3500,0,45,3545
Sao Paulo,106,3,2,0,acept,2430,0,31,2461
Sao Paulo,80,2,1,1,not acept,1500,167,20,1687
Sao Paulo,22,1,1,1,acept,2200,55,28,2283
Sao Paulo,141,4,3,2,acept,4010,542,51,4603
Sao Paulo,340,4,6,6,acept,15000,250,226,15476
Sao Paulo,105,4,2,2,acept,6500,400,83,6983
Sao Paulo,70,3,1,1,acept,1290,180,17,1487
Sao Paulo,200,3,2,1,acept,8000,42,102,8144
Campinas,62,2,1,0,acept,709,22,9,740
Sao Paulo,74,2,3,2,acept,3200,40,41,3281
Rio de Janeiro,333,5,4,3,acept,7000,1000,91,8091
Sao Paulo,250,4,2,5,acept,4000,701,61,4762
Sao Paulo,70,1,1,1,acept,3590,83,46,3719
Rio de Janeiro,120,3,2,2,acept,5500,509,71,6080
Porto Alegre,35,1,1,0,acept,960,75,15,1050
Rio de Janeiro,67,2,1,0,acept,1529,80,17,1626
Sao Paulo,220,4,3,4,acept,3000,1000,39,4039
Campinas,80,3,2,2,acept,2500,175,32,2707
Sao Paulo,57,1,1,1,acept,4800,194,61,5055
Porto Alegre,100,2,2,2,acept,2200,159,33,2392
Rio de Janeiro,60,1,1,0,acept,750,100,10,860
Campinas,87,3,2,1,acept,1450,100,19,1569
Sao Paulo,530,4,4,6,acept,9520,1334,144,10998
Sao Paulo,35,1,1,0,acept,700,80,11,791
Sao Paulo,140,3,2,2,acept,3000,2500,46,5546
Sao Paulo,45,2,2,0,not acept,1630,84,25,1739
Sao Paulo,70,1,1,1,acept,3500,171,45,3716
Sao Paulo,140,3,3,1,acept,1360,256,18,1634
Belo Horizonte,80,3,2,1,acept,2000,152,27,2179
Sao Paulo,50,1,1,0,not acept,1150,50,18,1218
Sao Paulo,108,3,2,2,not acept,2900,202,37,3139
Sao Paulo,60,3,1,1,acept,2200,4,31,2235
Sao Paulo,30,1,1,1,not acept,3500,100,45,3645
Sao Paulo,110,3,3,2,acept,3800,192,49,4041
Rio de Janeiro,70,2,1,1,acept,1100,84,15,1199
Sao Paulo,360,3,5,4,acept,3635,1644,47,5326
Campinas,348,3,3,3,acept,6000,350,91,6441
Sao Paulo,270,3,4,3,acept,7900,1792,101,9793
Rio de Janeiro,86,2,2,1,not acept,5500,375,71,5946
Sao Paulo,100,3,4,2,not acept,3000,470,39,3509
Sao Paulo,30,1,1,1,acept,1850,0,24,1874
Sao Paulo,146,3,4,3,acept,10000,667,127,10794
Belo Horizonte,100,3,3,1,acept,1600,120,22,1742
Rio de Janeiro,185,3,2,1,acept,6900,0,89,6989
Sao Paulo,300,3,5,2,acept,4600,609,70,5279
Sao Paulo,120,3,4,0,acept,3200,226,41,3467
Sao Paulo,195,3,3,2,acept,2990,330,45,3365
Sao Paulo,110,1,3,2,acept,8000,417,102,8519
Sao Paulo,210,3,3,3,acept,7000,717,89,7806
Campinas,400,4,6,3,acept,6800,700,103,7603
Belo Horizonte,42,2,1,1,acept,690,63,10,763
Belo Horizonte,180,3,1,0,acept,3400,367,56,3823
Campinas,329,4,2,2,acept,6300,420,80,6800
Sao Paulo,44,1,1,0,acept,1400,0,18,1418
Belo Horizonte,28,1,1,1,not acept,1250,0,17,1267
Rio de Janeiro,90,3,2,1,not acept,3800,310,49,4159
Sao Paulo,90,2,1,0,acept,2150,212,28,2390
Sao Paulo,200,2,1,0,acept,2800,291,43,3134
Porto Alegre,240,3,4,3,acept,6000,184,107,6291
Porto Alegre,55,2,1,0,acept,1200,84,18,1302
Belo Horizonte,90,3,2,0,not acept,4200,150,56,4406
Sao Paulo,85,3,1,2,acept,1900,270,25,2195
Sao Paulo,255,4,4,3,acept,11900,0,151,12051
Sao Paulo,280,5,2,1,acept,8000,0,121,8121
Rio de Janeiro,32,1,1,0,acept,1400,66,19,1485
Belo Horizonte,29,1,1,0,not acept,1100,8,15,1123
Sao Paulo,48,1,1,1,acept,3000,142,39,3181
Campinas,170,3,2,2,acept,2300,98,35,2433
Belo Horizonte,45,1,1,1,not acept,3000,0,40,3040
Campinas,341,4,6,4,acept,13000,608,196,13804
Porto Alegre,80,2,2,0,acept,1638,0,19,1657
Rio de Janeiro,153,3,2,1,acept,2550,157,33,2740
Rio de Janeiro,120,3,2,1,acept,2200,0,29,2229
Sao Paulo,33,1,1,0,acept,1650,0,21,1671
Sao Paulo,180,4,4,2,acept,5500,507,70,6077
Campinas,84,3,1,1,acept,1200,147,16,1363
Sao Paulo,73,3,2,1,acept,2700,171,35,2906
Sao Paulo,50,1,2,1,not acept,3000,210,39,3249
Sao Paulo,40,1,1,1,not acept,4320,181,55,4556
Sao Paulo,216,3,4,4,acept,15000,900,191,16091
Sao Paulo,44,1,1,1,acept,2300,70,30,2400
Belo Horizonte,120,3,2,2,not acept,1700,331,23,2054
Porto Alegre,150,3,3,2,acept,8900,250,130,9280
Sao Paulo,136,3,2,3,acept,2500,325,32,2857
Porto Alegre,54,1,1,0,acept,1000,25,15,1040
Sao Paulo,100,2,1,1,acept,3800,234,49,4083
Sao Paulo,50,2,1,1,acept,1200,0,16,1216
Campinas,60,2,1,0,not acept,800,138,13,951
Rio de Janeiro,125,3,2,1,acept,3500,295,46,3841
Rio de Janeiro,28,1,1,0,acept,1870,0,25,1895
Porto Alegre,78,2,1,0,acept,1480,32,22,1534
Porto Alegre,46,1,1,0,acept,850,27,13,890
Sao Paulo,35,1,1,1,not acept,2896,78,37,3011
Sao Paulo,104,3,2,2,acept,4200,432,54,4686
Sao Paulo,215,3,3,2,not acept,15000,834,191,16025
Campinas,100,3,2,2,acept,2250,15,34,2299
Belo Horizonte,30,1,1,1,not acept,705,0,10,715
Porto Alegre,43,1,1,0,acept,1500,25,22,1547
Sao Paulo,234,3,4,3,acept,7000,84,89,7173
Sao Paulo,37,1,1,0,acept,1730,142,22,1894
Sao Paulo,50,2,1,0,acept,2000,42,26,2068
Rio de Janeiro,71,2,2,1,acept,3500,190,46,3736
Sao Paulo,118,3,3,2,acept,3890,356,50,4296
Campinas,122,3,2,1,acept,1750,117,23,1890
Rio de Janeiro,58,2,2,1,acept,1200,44,16,1260
Sao Paulo,270,3,3,2,acept,9800,0,148,9948
Porto Alegre,90,3,2,2,acept,2500,202,37,2739
Sao Paulo,400,4,3,3,acept,8000,1250,121,9371
Campinas,155,3,3,2,acept,5500,15,83,5598
Rio de Janeiro,85,2,1,0,acept,2975,134,39,3148
Sao Paulo,280,4,4,4,acept,12000,1667,172,13839
Rio de Janeiro,30,1,1,0,acept,2000,45,26,2071
Sao Paulo,54,1,2,0,acept,3500,0,45,3545
Porto Alegre,25,1,1,0,acept,750,27,11,788
Belo Horizonte,176,4,2,2,acept,4500,226,74,4800
Sao Paulo,570,4,6,4,acept,10500,1834,158,12492
Belo Horizonte,95,2,2,1,acept,1600,170,22,1792
Sao Paulo,30,1,1,0,acept,1153,0,4,1157
Sao Paulo,250,3,4,3,acept,3571,430,54,4055
Sao Paulo,98,3,3,2,acept,2500,0,38,2538
Belo Horizonte,68,2,2,2,acept,800,59,11,870
Sao Paulo,83,3,2,2,acept,3690,317,47,4054
Belo Horizonte,70,2,2,2,acept,2250,211,30,2491
Belo Horizonte,50,2,1,1,acept,1000,28,14,1042
Sao Paulo,480,4,5,3,acept,4100,1700,62,5862
Sao Paulo,250,3,2,8,acept,10000,0,151,10151
Sao Paulo,191,4,3,3,not acept,9500,1200,121,10821
Sao Paulo,140,3,3,3,not acept,8000,800,102,8902
Sao Paulo,49,1,1,1,acept,2600,134,33,2767
Belo Horizonte,362,5,4,4,not acept,7900,1504,106,9510
Rio de Janeiro,61,2,1,0,acept,1297,21,17,1335
Porto Alegre,156,3,2,1,acept,1615,110,29,1754
Sao Paulo,179,3,2,1,acept,5400,359,69,5828
Rio de Janeiro,120,3,3,2,acept,2800,150,37,2987
Belo Horizonte,200,4,2,2,acept,12000,233,197,12430
Sao Paulo,185,3,3,3,acept,5600,907,71,6578
Sao Paulo,120,2,2,0,acept,3600,120,46,3766
Sao Paulo,50,2,1,1,acept,1715,12,22,1749
Belo Horizonte,400,3,3,2,acept,4800,0,79,4879
Sao Paulo,240,3,4,2,acept,8200,625,124,8949
Sao Paulo,60,2,1,1,acept,1520,80,20,1620
Sao Paulo,100,2,1,3,not acept,2700,378,41,3119
Sao Paulo,250,4,4,3,not acept,7500,417,113,8030
Porto Alegre,100,4,2,1,acept,1820,167,27,2014
Rio de Janeiro,72,1,2,1,acept,2000,0,26,2026
Rio de Janeiro,70,2,1,0,acept,2000,7,26,2033
Sao Paulo,16,1,1,0,acept,2700,5,35,2740
Sao Paulo,98,3,2,2,acept,4500,0,58,4558
Sao Paulo,170,3,3,1,acept,2060,200,27,2287
Sao Paulo,45,2,1,0,not acept,1450,43,22,1515
Sao Paulo,90,2,2,1,acept,5500,142,70,5712
Sao Paulo,30,1,1,1,acept,2570,0,8,2578
Sao Paulo,140,3,3,2,acept,4905,59,63,5027
Sao Paulo,90,2,2,2,acept,3640,342,47,4029
Belo Horizonte,62,2,2,0,acept,1300,0,18,1318
Rio de Janeiro,80,2,2,0,acept,2500,0,33,2533
Sao Paulo,40,1,1,0,not acept,750,0,12,762
Rio de Janeiro,65,1,1,0,acept,1800,30,24,1854
Sao Paulo,300,3,2,1,acept,3900,538,59,4497
Sao Paulo,340,4,4,3,acept,10000,1084,151,11235
Sao Paulo,72,2,2,1,acept,5270,334,67,5671
Sao Paulo,250,4,3,3,not acept,13000,950,196,14146
Rio de Janeiro,100,2,2,3,not acept,3478,180,45,3703
Sao Paulo,45,1,1,1,not acept,5520,0,70,5590
Porto Alegre,98,3,1,0,not acept,12750,50,187,12987
Belo Horizonte,164,3,2,2,acept,3200,131,53,3384
Sao Paulo,250,3,3,4,acept,6500,309,98,6907
Rio de Janeiro,28,1,1,0,acept,1189,0,16,1205
Rio de Janeiro,60,2,1,0,not acept,1650,0,22,1672
Sao Paulo,105,3,3,2,not acept,2720,417,35,3172
Sao Paulo,220,2,4,3,not acept,12960,834,165,13959
Rio de Janeiro,250,5,3,1,acept,4000,100,61,4161
Sao Paulo,171,3,3,1,acept,5100,259,65,5424
Rio de Janeiro,156,4,3,2,acept,3900,600,51,4551
Sao Paulo,150,3,5,3,acept,4500,189,68,4757
Belo Horizonte,75,3,2,1,acept,1500,50,20,1570
Sao Paulo,254,3,5,4,acept,10000,990,127,11117
Sao Paulo,68,1,2,1,acept,9000,532,115,9647
Sao Paulo,55,2,1,0,not acept,1528,0,20,1548
Porto Alegre,40,1,1,0,acept,800,19,12,831
Sao Paulo,230,2,3,1,acept,12000,450,153,12603
Porto Alegre,70,2,2,0,not acept,1995,80,30,2105
Sao Paulo,170,4,5,2,acept,3700,0,56,3756
Porto Alegre,40,1,1,1,acept,1050,67,16,1133
Sao Paulo,45,1,1,1,not acept,5520,0,70,5590
Sao Paulo,270,3,4,3,acept,7500,1471,96,9067
Campinas,54,2,1,1,acept,1500,23,20,1543
Campinas,291,4,3,2,acept,3300,208,50,3558
Belo Horizonte,86,2,1,1,acept,1310,130,18,1458
Sao Paulo,77,2,1,1,acept,2200,0,28,2228
Sao Paulo,86,3,2,2,acept,2900,190,37,3127
Campinas,200,3,4,2,not acept,2000,275,26,2301
Sao Paulo,90,2,2,2,not acept,4800,203,61,5064
Sao Paulo,64,2,2,2,acept,3400,161,44,3605
Porto Alegre,54,2,1,2,acept,1310,30,20,1360
Porto Alegre,387,7,5,3,acept,6000,394,107,6501
Sao Paulo,100,2,3,2,not acept,10000,138,127,10265
Sao Paulo,50,2,2,1,acept,1800,0,23,1823
Belo Horizonte,520,3,3,4,not acept,12000,1133,160,13293
Sao Paulo,23,1,1,0,acept,2100,59,27,2186
Rio de Janeiro,60,1,1,0,acept,1580,0,21,1601
Sao Paulo,96,2,1,1,not acept,3000,0,39,3039
Sao Paulo,140,3,1,0,acept,2700,167,41,2908
Rio de Janeiro,103,3,2,0,acept,2750,200,36,2986
Sao Paulo,148,4,4,4,acept,2000,406,26,2432
Sao Paulo,172,4,3,1,acept,3500,114,53,3667
Sao Paulo,93,2,3,2,acept,3200,350,41,3591
Sao Paulo,72,2,2,1,acept,2300,200,30,2530
Campinas,68,2,1,1,acept,1500,70,20,1590
Sao Paulo,350,4,3,4,acept,4000,209,61,4270
Rio de Janeiro,70,2,2,1,acept,3500,225,46,3771
Sao Paulo,400,5,4,3,acept,6900,1017,104,8021
Porto Alegre,38,1,1,0,acept,690,9,11,710
Sao Paulo,107,2,2,1,not acept,8400,293,107,8800
Sao Paulo,38,1,1,0,not acept,950,0,13,963
Sao Paulo,111,3,2,0,acept,2500,264,32,2796
Sao Paulo,140,4,3,2,acept,3800,334,49,4183
Sao Paulo,35,1,1,0,acept,1150,30,15,1195
Sao Paulo,178,3,3,4,not acept,15000,850,191,16041
Sao Paulo,200,2,2,1,acept,9500,600,121,10221
Sao Paulo,33,1,1,0,not acept,1000,63,13,1076
Belo Horizonte,90,3,2,1,not acept,1600,140,22,1762
Rio de Janeiro,65,2,1,0,not acept,1600,67,21,1688
Sao Paulo,320,3,3,8,acept,5500,572,83,6155
Porto Alegre,68,2,1,0,acept,1320,26,20,1366
Porto Alegre,180,6,2,3,acept,4800,242,71,5113
Sao Paulo,50,2,1,1,not acept,1300,69,20,1389
Sao Paulo,137,3,2,1,acept,4700,293,60,5053
Sao Paulo,165,3,2,2,acept,6500,779,83,7362
Sao Paulo,180,2,2,1,acept,5350,0,68,5418
Sao Paulo,220,4,4,3,acept,5100,892,65,6057
Belo Horizonte,85,2,2,1,acept,2800,0,38,2838
Rio de Janeiro,37,1,1,0,not acept,1400,209,19,1628
Porto Alegre,64,2,3,2,acept,2750,113,41,2904
Rio de Janeiro,97,2,2,1,acept,4400,334,57,4791
Belo Horizonte,90,3,2,1,acept,1300,115,18,1433
Rio de Janeiro,130,3,2,1,acept,4500,209,58,4767
Campinas,128,4,2,1,not acept,3400,59,44,3503
Sao Paulo,58,2,2,1,not acept,4000,256,51,4307
Belo Horizonte,76,2,1,1,not acept,900,0,12,912
Sao Paulo,220,2,4,2,acept,6200,1200,94,7494
Sao Paulo,40,1,1,0,not acept,780,17,12,809
Sao Paulo,235,3,4,3,acept,2550,1000,33,3583
Belo Horizonte,45,1,1,0,acept,1100,55,15,1170
Sao Paulo,47,2,1,1,not acept,1100,0,14,1114
Belo Horizonte,471,5,6,3,acept,14000,1297,230,15527
Campinas,50,1,1,0,acept,520,23,7,550
Belo Horizonte,344,3,4,4,not acept,15000,1231,200,16431
Sao Paulo,38,1,1,1,not acept,1850,28,24,1902
Porto Alegre,42,2,1,0,acept,860,13,16,889
Belo Horizonte,60,1,1,1,acept,1400,101,19,1520
Sao Paulo,500,4,6,4,acept,13000,2200,196,15396
Sao Paulo,49,2,1,1,acept,1700,21,22,1743
Belo Horizonte,48,2,1,1,acept,900,96,12,1008
Sao Paulo,45,2,1,0,not acept,1300,109,20,1429
Porto Alegre,72,2,2,1,acept,1200,60,18,1278
Belo Horizonte,400,3,2,1,acept,1600,258,27,1885
Sao Paulo,28,1,1,0,not acept,1750,0,23,1773
Rio de Janeiro,189,3,2,2,acept,8500,489,110,9099
Sao Paulo,160,3,2,0,acept,3900,150,50,4100
Rio de Janeiro,330,4,4,2,acept,15000,1084,110,16194
Sao Paulo,200,3,5,4,acept,1720,959,22,2701
Sao Paulo,375,4,5,5,acept,15000,2805,191,17996
Sao Paulo,68,2,2,1,acept,1877,0,24,1901
Sao Paulo,70,2,1,1,acept,2500,92,32,2624
Rio de Janeiro,110,3,2,0,not acept,2950,303,39,3292
Sao Paulo,103,3,3,2,not acept,5600,330,71,6001
Rio de Janeiro,26,1,1,0,not acept,1500,59,20,1579
Belo Horizonte,88,3,2,2,not acept,1200,109,16,1325
Sao Paulo,165,3,4,3,acept,4500,573,58,5131
Sao Paulo,80,2,2,0,not acept,1100,167,17,1284
Porto Alegre,90,3,2,2,acept,2780,116,41,2937
Sao Paulo,380,4,1,2,not acept,4000,386,61,4447
Sao Paulo,174,3,4,2,acept,6000,390,77,6467
Sao Paulo,128,4,5,1,acept,6800,71,87,6958
Sao Paulo,160,3,4,4,acept,2100,480,27,2607
Rio de Janeiro,168,3,2,0,acept,3700,417,48,4165
Campinas,100,3,2,2,acept,2200,105,28,2333
Rio de Janeiro,69,2,1,1,acept,1370,56,18,1444
Belo Horizonte,300,3,3,0,acept,5000,0,82,5082
Belo Horizonte,163,4,4,0,acept,7500,22,100,7622
Sao Paulo,86,3,1,1,acept,2200,116,28,2344
Sao Paulo,236,4,3,3,acept,1600,1015,21,2636
Rio de Janeiro,112,3,2,0,acept,3900,271,51,4222
Sao Paulo,600,5,5,6,acept,12750,1059,192,14001
Campinas,256,4,5,4,acept,3000,1167,39,4206
Sao Paulo,220,3,4,2,not acept,3500,276,53,3829
Sao Paulo,257,4,4,4,not acept,12000,1584,153,13737
Belo Horizonte,75,3,1,1,acept,1500,66,20,1586
Rio de Janeiro,400,3,1,1,acept,7650,666,117,8433
Sao Paulo,560,4,6,5,acept,6550,1700,99,8349
Sao Paulo,220,4,4,5,not acept,4600,0,59,4659
Rio de Janeiro,70,1,1,1,acept,3500,255,46,3801
Belo Horizonte,19,1,1,0,not acept,1200,37,16,1253
Sao Paulo,35,1,1,0,acept,900,11,14,925
Sao Paulo,70,1,1,1,acept,2600,66,33,2699
Sao Paulo,40,1,1,0,not acept,3300,74,42,3416
Porto Alegre,37,1,1,0,acept,1500,67,22,1589
Sao Paulo,180,2,2,1,acept,9000,480,115,9595
Rio de Janeiro,60,1,1,0,not acept,2300,140,30,2470
Rio de Janeiro,90,3,2,1,acept,2050,60,27,2137
Sao Paulo,208,4,2,4,acept,4500,282,68,4850
Rio de Janeiro,160,3,2,1,acept,4700,275,61,5036
Belo Horizonte,180,4,2,1,acept,3610,248,49,3907
Porto Alegre,150,4,3,0,acept,3300,800,59,4159
Campinas,75,2,1,1,acept,1080,80,17,1177
Rio de Janeiro,90,2,2,1,acept,1039,350,14,1403
Sao Paulo,170,4,2,2,acept,2900,50,44,2994
Sao Paulo,193,2,4,4,acept,13000,1323,165,14488
Sao Paulo,40,1,1,0,acept,2300,39,30,2369
Sao Paulo,45,1,1,1,acept,3850,209,49,4108
Sao Paulo,116,3,4,2,acept,8000,584,102,8686
Sao Paulo,67,2,2,1,acept,2300,0,30,2330
Sao Paulo,40,1,1,0,not acept,1920,117,25,2062
Sao Paulo,140,2,3,1,acept,3850,150,58,4058
Campinas,52,2,1,1,acept,980,77,13,1070
Sao Paulo,350,3,4,6,acept,3850,834,58,4742
Sao Paulo,420,3,4,4,not acept,6000,417,91,6508
Porto Alegre,204,4,4,2,acept,3440,100,62,3602
Sao Paulo,110,2,2,1,acept,2200,192,34,2426
Sao Paulo,645,5,8,8,acept,15000,2334,226,17560
Sao Paulo,260,4,5,5,acept,11000,2441,140,13581
Sao Paulo,160,2,1,0,not acept,2400,0,31,2431
Sao Paulo,50,2,1,0,acept,1200,42,19,1261
Rio de Janeiro,40,1,2,0,acept,1800,53,24,1877
Rio de Janeiro,60,2,1,0,acept,3000,84,39,3123
Rio de Janeiro,30,1,1,0,acept,1000,50,13,1063
Rio de Janeiro,75,3,2,0,acept,1615,124,12,1751
Rio de Janeiro,78,3,3,1,acept,2850,206,37,3093
Belo Horizonte,140,4,2,2,acept,3500,413,47,3960
Campinas,500,3,7,5,acept,7950,900,101,8951
Porto Alegre,80,1,1,0,acept,971,15,18,1004
Porto Alegre,182,3,4,2,acept,2900,74,52,3026
Sao Paulo,90,2,1,1,acept,2735,19,42,2796
Sao Paulo,103,3,2,1,acept,1500,137,6,1643
Porto Alegre,180,3,2,3,acept,5100,250,75,5425
Belo Horizonte,32,1,1,0,not acept,1100,0,15,1115
Campinas,52,1,1,1,acept,750,46,10,806
Rio de Janeiro,75,4,1,0,acept,2200,34,29,2263
Belo Horizonte,290,4,5,4,acept,6000,500,99,6599
Rio de Janeiro,50,1,1,1,acept,2000,0,10,2010
Sao Paulo,550,5,6,4,acept,15000,1119,226,16345
Sao Paulo,216,4,4,4,acept,2800,686,36,3522
Sao Paulo,444,4,4,5,acept,10000,584,151,10735
Porto Alegre,69,3,2,1,acept,1850,65,28,1943
Belo Horizonte,76,2,1,2,not acept,2100,99,28,2227
Sao Paulo,180,3,5,3,acept,8100,0,103,8203
Sao Paulo,445,3,5,4,acept,15000,1339,226,16565
Sao Paulo,156,3,4,3,acept,4200,305,54,4559
Sao Paulo,35,1,1,0,acept,1100,30,14,1144
Sao Paulo,130,3,4,3,acept,2400,597,31,3028
Porto Alegre,92,3,2,1,acept,3200,75,47,3322
Sao Paulo,200,3,2,4,acept,8500,407,128,9035
Sao Paulo,50,2,1,1,acept,1300,4,17,1321
Belo Horizonte,50,2,1,0,not acept,850,25,14,889
Sao Paulo,155,3,3,2,acept,12000,700,153,12853
Belo Horizonte,1000,5,4,3,acept,7000,634,94,7728
Rio de Janeiro,42,1,1,0,not acept,1920,34,25,1979
Sao Paulo,58,2,1,0,acept,1480,52,19,1551
Sao Paulo,35,1,1,1,not acept,3365,153,43,3561
Belo Horizonte,27,1,1,0,not acept,1167,334,16,1517
Belo Horizonte,16,1,1,0,not acept,650,50,9,709
Belo Horizonte,94,3,2,1,not acept,1900,125,26,2051
Porto Alegre,83,3,2,1,acept,2500,101,37,2638
Belo Horizonte,360,5,4,4,acept,9000,600,148,9748
Belo Horizonte,360,5,2,2,acept,4600,436,62,5098
Campinas,430,4,5,5,acept,13000,474,196,13670
Belo Horizonte,29,1,1,0,acept,1100,8,15,1123
Rio de Janeiro,120,3,2,0,acept,2490,105,33,2628
Sao Paulo,50,1,1,1,acept,4500,251,58,4809
Porto Alegre,60,2,1,0,acept,650,42,12,704
Sao Paulo,45,2,2,0,not acept,1630,84,25,1739
Rio de Janeiro,250,3,2,2,acept,12000,542,183,12725
Sao Paulo,200,3,2,2,acept,4700,184,71,4955
Rio de Janeiro,70,2,1,1,acept,2500,105,33,2638
Sao Paulo,48,1,1,0,not acept,1100,9,17,1126
Sao Paulo,70,2,1,1,not acept,2500,14,32,2546
Sao Paulo,73,2,2,1,acept,5000,196,64,5260
Sao Paulo,90,2,1,0,not acept,2700,25,35,2760
Porto Alegre,45,1,1,0,acept,640,84,10,734
Sao Paulo,80,2,2,2,not acept,3600,390,55,4045
Sao Paulo,106,3,2,2,acept,5520,275,70,5865
Belo Horizonte,45,2,1,1,acept,850,63,12,925
Sao Paulo,315,4,4,2,acept,7450,0,95,7545
Sao Paulo,287,3,5,0,acept,12000,1421,153,13574
Belo Horizonte,230,4,3,2,acept,5500,48,74,5622
Sao Paulo,42,1,2,1,not acept,2500,313700,32,316232
Rio de Janeiro,152,2,2,1,acept,1500,342,20,1862
Campinas,75,3,1,2,acept,1300,74,17,1391
Sao Paulo,94,3,2,2,acept,2000,42,26,2068
Rio de Janeiro,70,2,2,0,not acept,2100,13,28,2141
Sao Paulo,59,2,1,0,acept,1750,0,23,1773
Sao Paulo,380,4,3,2,not acept,15000,1000,191,16191
Sao Paulo,217,4,4,3,acept,4910,1417,63,6390
Sao Paulo,110,2,1,1,acept,2800,137,36,2973
Campinas,38,1,1,0,acept,550,70,7,627
Sao Paulo,310,4,5,5,acept,12000,2709,153,14862
Sao Paulo,400,3,4,2,acept,3150,0,48,3198
Porto Alegre,55,2,1,1,acept,1500,83,22,1605
Sao Paulo,320,3,5,0,not acept,6000,2417,77,8494
Campinas,75,3,2,2,not acept,1600,75,21,1696
Belo Horizonte,235,4,5,3,acept,3300,496,44,3840
Belo Horizonte,434,5,6,0,not acept,11000,2192,147,13339
Sao Paulo,160,4,4,2,not acept,7000,275,89,7364
Sao Paulo,108,3,2,2,acept,4348,250,56,4654
Sao Paulo,280,5,5,2,acept,12750,929,162,13841
Rio de Janeiro,55,2,1,1,acept,680,125,9,814
Rio de Janeiro,60,2,1,1,not acept,1500,55,20,1575
Sao Paulo,226,4,4,3,not acept,10000,1200,127,11327
Belo Horizonte,58,2,1,1,acept,900,0,12,912
Sao Paulo,178,4,3,2,acept,6700,660,85,7445
Porto Alegre,40,1,1,0,acept,1150,35,17,1202
Campinas,205,3,2,4,acept,2490,57,38,2585
Sao Paulo,112,3,2,3,acept,2500,332,32,2864
Belo Horizonte,300,4,4,3,acept,15000,1100,200,16300
Sao Paulo,140,3,3,2,acept,5000,300,76,5376
Belo Horizonte,113,2,2,2,acept,2600,116,35,2751
Belo Horizonte,96,3,2,2,not acept,1400,120,19,1539
Sao Paulo,55,1,2,1,acept,3500,0,45,3545
Sao Paulo,180,2,3,3,acept,7600,1025,54,8679
Sao Paulo,240,7,3,4,acept,6000,834,91,6925
Sao Paulo,80,3,4,1,acept,3000,0,46,3046
Belo Horizonte,230,5,3,2,acept,2200,249,30,2479
Belo Horizonte,127,3,2,3,acept,3000,317,40,3357
Belo Horizonte,156,4,4,3,acept,6500,369,87,6956
Sao Paulo,65,2,1,2,acept,4000,233,51,4284
Sao Paulo,88,2,2,2,acept,4500,134,58,4692
Porto Alegre,107,3,2,1,acept,2000,42,36,2078
Rio de Janeiro,60,2,1,1,acept,1200,55,16,1271
Porto Alegre,35,1,1,0,acept,550,9,9,568
Porto Alegre,243,3,5,1,acept,5556,667,82,6305
Sao Paulo,30,1,1,0,not acept,850,67,13,930
Campinas,45,1,1,1,acept,870,46,12,928
Rio de Janeiro,130,3,2,2,acept,3000,167,46,3213
Porto Alegre,80,2,2,0,acept,2800,0,41,2841
Sao Paulo,98,2,2,1,acept,2166,384,28,2578
Sao Paulo,15,1,1,0,not acept,1200,83,16,1299
Rio de Janeiro,57,2,2,1,acept,1800,281,24,2105
Porto Alegre,180,4,2,2,acept,2400,109,36,2545
Sao Paulo,200,4,4,3,acept,7000,834,89,7923
Rio de Janeiro,70,2,2,1,acept,1900,55,29,1984
Sao Paulo,350,2,1,0,acept,2500,209,38,2747
Porto Alegre,64,2,1,0,not acept,1700,9,25,1734
Porto Alegre,40,1,1,0,not acept,750,0,14,764
Belo Horizonte,73,1,1,0,acept,700,0,10,710
Sao Paulo,200,3,3,2,acept,12000,834,153,12987
Sao Paulo,36,1,1,1,acept,1990,119,26,2135
Campinas,63,2,1,0,acept,850,26,11,887
Sao Paulo,85,2,1,1,acept,3500,105,45,3650
Sao Paulo,198,5,5,2,acept,3801,554,49,4404
Campinas,70,3,1,1,acept,940,64,12,1016
Belo Horizonte,60,2,1,1,not acept,1000,20,14,1034
Belo Horizonte,90,4,3,1,acept,950,83,13,1046
Porto Alegre,98,2,1,0,acept,1800,91,27,1918
Sao Paulo,103,3,2,2,acept,3000,459,39,3498
Sao Paulo,160,2,3,0,acept,4300,124,65,4489
Rio de Janeiro,100,3,2,1,acept,4000,184,52,4236
Sao Paulo,50,2,1,1,acept,1000,0,13,1013
Sao Paulo,55,2,1,1,acept,1100,0,14,1114
Sao Paulo,80,2,2,0,not acept,2550,46,33,2629
Sao Paulo,50,1,1,0,acept,690,0,11,701
Rio de Janeiro,25,1,1,0,not acept,1900,0,25,1925
Sao Paulo,120,2,2,2,acept,5500,158,83,5741
Sao Paulo,127,3,3,2,acept,3800,257,49,4106
Sao Paulo,98,3,2,1,acept,5500,200,70,5770
Sao Paulo,65,1,1,0,not acept,3050,25,39,3114
Rio de Janeiro,86,2,2,2,acept,1200,8,16,1224
Porto Alegre,200,4,3,0,not acept,15000,834,267,16101
Sao Paulo,360,4,5,5,acept,10000,1666,127,11793
Sao Paulo,65,2,1,1,acept,1410,74,18,1502
Sao Paulo,93,1,3,1,not acept,3500,33,45,3578
Sao Paulo,187,4,5,3,acept,5300,1424,68,6792
Belo Horizonte,616,5,5,6,acept,12500,1103,205,13808
Rio de Janeiro,86,2,2,2,acept,1200,8,16,1224
Sao Paulo,139,2,2,1,acept,4396,153,56,4605
Rio de Janeiro,100,2,2,1,not acept,2000,13,26,2039
Sao Paulo,285,4,4,4,acept,8000,1750,102,9852
Sao Paulo,52,2,1,1,acept,3000,145,39,3184
Sao Paulo,39,1,1,0,acept,2000,0,26,2026
Porto Alegre,42,1,2,1,acept,1800,42,27,1869
Rio de Janeiro,30,1,1,0,acept,1386,34,18,1438
Rio de Janeiro,70,2,1,1,acept,900,122,12,1034
Sao Paulo,60,1,1,0,acept,1200,50,16,1266
Sao Paulo,90,2,2,2,acept,3040,322,39,3401
Porto Alegre,61,2,1,0,acept,850,30,13,893
Porto Alegre,50,1,1,0,acept,780,25,12,817
Campinas,48,2,1,1,acept,1545,49,20,1614
Sao Paulo,27,1,1,0,not acept,3500,1,45,3546
Belo Horizonte,100,3,3,1,acept,2600,300,35,2935
Sao Paulo,155,2,1,1,acept,4500,510,58,5068
Sao Paulo,230,4,5,0,acept,7600,300,115,8015
Campinas,47,1,1,1,acept,1100,46,14,1160
Campinas,55,2,1,1,acept,730,24,10,764
Campinas,60,1,1,1,acept,1100,1,14,1115
Belo Horizonte,380,5,6,2,acept,4500,125,74,4699
Sao Paulo,180,3,2,4,not acept,11000,667,166,11833
Porto Alegre,196,3,4,2,acept,4600,325,68,4993
Porto Alegre,70,2,1,0,acept,1300,42,19,1361
Sao Paulo,227,4,3,3,acept,10000,1700,127,11827
Sao Paulo,60,2,1,1,acept,2650,63,34,2747
Porto Alegre,63,2,2,1,acept,1960,6,29,1995
Sao Paulo,150,3,3,2,acept,3400,200,44,3644
Campinas,144,4,3,2,acept,1750,210,23,1983
Rio de Janeiro,200,2,1,0,acept,3000,0,46,3046
Sao Paulo,34,2,1,0,acept,2200,15,28,2243
Sao Paulo,74,2,3,2,acept,3200,40,41,3281
Porto Alegre,73,3,1,0,acept,1800,44,27,1871
Sao Paulo,368,4,5,6,not acept,8500,2037,108,10645
Rio de Janeiro,160,3,2,1,acept,2300,205,30,2535
Belo Horizonte,120,4,3,2,acept,3250,0,44,3294
Belo Horizonte,180,4,3,4,not acept,12000,695,160,12855
Belo Horizonte,290,3,3,0,acept,6000,276,99,6375
Sao Paulo,225,4,3,2,acept,3995,132,61,4188
Campinas,60,3,1,1,not acept,1087,67,14,1168
Sao Paulo,35,1,1,0,not acept,1305,0,17,1322
Sao Paulo,95,3,2,1,acept,6500,280,83,6863
Belo Horizonte,260,4,4,0,acept,6500,241,87,6828
Sao Paulo,260,4,4,4,acept,10000,1163,127,11290
Rio de Janeiro,350,3,2,3,acept,15000,834,229,16063
Sao Paulo,500,4,4,0,acept,6000,467,91,6558
Porto Alegre,42,1,1,1,acept,2198,0,33,2231
Sao Paulo,80,2,1,1,acept,3500,188,45,3733
Sao Paulo,100,5,5,2,not acept,4500,382,68,4950
Sao Paulo,110,2,2,2,acept,2300,109,30,2439
Sao Paulo,70,1,1,0,not acept,1520,125,23,1668
Sao Paulo,12,1,1,0,not acept,950,50,13,1013
Sao Paulo,62,1,1,1,not acept,1300,9,20,1329
Sao Paulo,90,2,1,1,acept,1600,84,21,1705
Sao Paulo,220,3,3,2,acept,9000,584,115,9699
Porto Alegre,197,3,2,3,acept,7000,425,103,7528
Sao Paulo,214,3,2,5,acept,14000,2469,178,16647
Rio de Janeiro,105,3,2,1,acept,1750,147,23,1920
Belo Horizonte,390,5,5,5,not acept,8000,797,107,8904
Sao Paulo,390,4,5,4,acept,11500,784,173,12457
Rio de Janeiro,105,3,2,1,acept,3700,380,28,4108
Sao Paulo,270,3,6,2,acept,3270,1000,42,4312
Belo Horizonte,260,4,4,5,not acept,4500,407,60,4967
Rio de Janeiro,344,4,3,2,acept,3612,419,47,4078
Sao Paulo,100,2,1,0,not acept,2000,110,31,2141
Rio de Janeiro,50,2,1,0,acept,1800,50,24,1874
Sao Paulo,183,4,3,4,acept,5950,192,76,6218
Sao Paulo,270,4,5,3,acept,9753,1500,124,11377
Sao Paulo,180,2,3,2,acept,5900,604,75,6579
Sao Paulo,52,2,1,1,not acept,1580,0,21,1601
Sao Paulo,260,4,4,4,acept,4500,0,68,4568
Rio de Janeiro,38,1,1,1,acept,1450,0,19,1469
Sao Paulo,40,1,1,1,acept,2990,409,38,3437
Sao Paulo,360,4,5,4,acept,7800,1350,99,9249
Porto Alegre,160,3,3,3,acept,8950,621,131,9702
Sao Paulo,120,3,2,2,acept,4800,192,73,5065
Sao Paulo,70,2,1,1,acept,1000,138,13,1151
Campinas,203,3,1,2,acept,3300,117,50,3467
Sao Paulo,18,1,1,0,not acept,1260,0,16,1276
Rio de Janeiro,50,2,1,1,acept,1550,13,20,1583
Sao Paulo,33,1,1,0,acept,1300,50,17,1367
Sao Paulo,30,1,1,0,acept,1090,75,14,1179
Sao Paulo,330,2,4,3,acept,6000,2000,91,8091
Porto Alegre,60,2,2,1,not acept,2170,67,32,2269
Sao Paulo,144,3,4,3,acept,7200,589,92,7881
Rio de Janeiro,93,2,1,1,acept,5500,317,71,5888
Sao Paulo,100,2,1,1,acept,1900,84,29,2013
Porto Alegre,71,3,1,0,acept,1250,46,19,1315
Rio de Janeiro,67,1,1,1,acept,800,123,11,934
Sao Paulo,70,2,1,0,acept,3000,50,39,3089
Belo Horizonte,300,4,6,4,acept,13000,1387,174,14561
Sao Paulo,240,3,2,2,not acept,9800,667,125,10592
Sao Paulo,96,3,1,2,acept,1847,15,24,1886
Sao Paulo,200,4,3,2,acept,4500,1334,58,5892
Campinas,54,1,2,1,acept,3500,0,45,3545
Sao Paulo,174,3,5,3,acept,6800,4565,87,11452
Sao Paulo,350,3,4,4,acept,15000,1234,226,16460
Belo Horizonte,92,3,2,2,acept,1950,171,26,2147
Belo Horizonte,125,3,2,0,acept,1850,384,25,2259
Campinas,308,3,4,4,acept,8000,478,121,8599
Sao Paulo,375,4,5,4,acept,12750,959,192,13901
Sao Paulo,137,3,4,2,acept,2200,334,28,2562
Belo Horizonte,70,1,1,0,acept,1100,135,15,1250
Belo Horizonte,65,2,2,1,acept,1200,96,16,1312
Sao Paulo,107,2,2,2,acept,12800,417,163,13380
Sao Paulo,85,2,2,1,acept,4131,311,53,4495
Sao Paulo,69,2,1,0,acept,3000,0,22,3022
Belo Horizonte,110,3,2,1,not acept,1400,150,19,1569
Porto Alegre,113,3,2,3,acept,2200,100,33,2333
Sao Paulo,213,4,3,0,acept,5100,0,65,5165
Sao Paulo,140,2,2,2,not acept,2700,56,41,2797
Belo Horizonte,253,3,3,3,acept,2400,251,32,2683
Belo Horizonte,490,4,4,3,acept,9000,585,148,9733
Sao Paulo,96,4,2,2,acept,3710,412,56,4178
Sao Paulo,23,1,1,0,acept,2100,59,27,2186
Rio de Janeiro,80,2,2,1,not acept,5000,380,65,5445
Sao Paulo,92,3,2,2,acept,3500,317,45,3862
Rio de Janeiro,25,1,1,0,acept,1900,350,25,2275
Sao Paulo,220,3,2,8,acept,4335,263,66,4664
Sao Paulo,70,3,1,1,acept,2000,67,26,2093
Sao Paulo,130,3,2,1,not acept,4300,167,55,4522
Rio de Janeiro,120,3,2,0,acept,1800,162,24,1986
Sao Paulo,208,3,2,1,acept,7000,384,89,7473
Belo Horizonte,70,2,1,2,acept,2000,27,27,2054
Sao Paulo,160,5,3,3,acept,4460,321,68,4849
Belo Horizonte,214,4,3,3,not acept,5600,798,75,6473
Sao Paulo,40,1,1,1,acept,3179,0,41,3220
Rio de Janeiro,64,2,1,0,not acept,3500,125,46,3671
Sao Paulo,290,4,5,2,acept,10000,875,127,11002
Porto Alegre,35,1,1,0,acept,850,9,13,872
Sao Paulo,138,2,3,2,acept,8000,455,102,8557
Belo Horizonte,78,2,3,2,acept,2500,209,34,2743
Belo Horizonte,92,3,1,1,acept,1900,81,26,2007
Porto Alegre,513,3,2,2,acept,2900,100,43,3043
Campinas,58,1,1,1,acept,1270,64,17,1351
Sao Paulo,51,1,1,1,acept,4650,190,59,4899
Belo Horizonte,200,4,5,3,not acept,9000,134,120,9254
Porto Alegre,115,1,1,0,acept,1600,150,24,1774
Rio de Janeiro,64,2,1,1,acept,1900,258,25,2183
Campinas,40,1,1,1,not acept,1000,0,13,1013
Rio de Janeiro,159,3,2,2,acept,1900,650,25,2575
Rio de Janeiro,35,1,1,0,acept,1850,74,24,1948
Sao Paulo,192,3,1,0,not acept,1560,125,24,1709
Sao Paulo,250,5,5,0,acept,4500,0,68,4568
Campinas,43,1,1,0,not acept,660,14,9,683
Belo Horizonte,142,3,3,2,acept,2000,114,33,2147
Belo Horizonte,244,4,3,3,acept,2900,276,39,3215
Sao Paulo,200,3,2,3,acept,8000,667,102,8769
Campinas,55,2,1,1,acept,700,40,9,749
Sao Paulo,108,4,2,0,acept,5500,142,70,5712
Sao Paulo,120,3,1,0,acept,2200,0,34,2234
Sao Paulo,44,1,1,1,not acept,4300,477,55,4832
Belo Horizonte,50,2,1,1,acept,1140,0,16,1156
Sao Paulo,87,2,2,2,acept,3800,250,49,4099
Sao Paulo,88,3,2,2,acept,5870,108,75,6053
Sao Paulo,376,3,3,2,acept,1800,300,28,2128
Porto Alegre,38,1,1,1,acept,1490,46,22,1558
Campinas,45,1,1,1,acept,880,38,12,930
Rio de Janeiro,36,1,1,0,not acept,1627,1,21,1649
Rio de Janeiro,75,2,1,1,acept,1360,33,18,1411
Sao Paulo,85,2,2,1,not acept,3000,71,39,3110
Sao Paulo,35,1,1,0,acept,1100,30,14,1144
Porto Alegre,58,2,2,2,acept,2470,0,37,2507
Sao Paulo,90,2,3,1,acept,2300,3,35,2338
Porto Alegre,87,2,1,1,acept,1550,43,23,1616
Sao Paulo,136,3,2,2,not acept,8090,417,103,8610
Rio de Janeiro,124,3,2,2,not acept,5400,250,70,5720
Sao Paulo,51,1,1,0,acept,2500,79,32,2611
Campinas,90,2,1,0,not acept,1700,105,26,1831
Porto Alegre,270,2,3,1,acept,6500,38,116,6654
Campinas,200,4,3,2,acept,3400,209,44,3653
Porto Alegre,79,3,1,0,acept,1140,500,17,1657
Sao Paulo,40,2,1,1,acept,3300,0,42,3342
Sao Paulo,300,3,5,4,acept,6600,634,100,7334
Sao Paulo,44,1,1,0,not acept,1900,104,25,2029
Sao Paulo,130,3,2,2,acept,2200,0,34,2234
Sao Paulo,180,3,4,3,acept,6400,690,82,7172
Sao Paulo,79,3,2,2,not acept,3200,26,41,3267
Belo Horizonte,50,1,1,1,not acept,1850,202,25,2077
Campinas,110,3,1,1,acept,1500,50,23,1573
Sao Paulo,17,1,1,0,not acept,2200,50,28,2278
Belo Horizonte,60,2,1,1,acept,2100,162,28,2290
Rio de Janeiro,95,2,2,0,acept,1700,141,22,1863
Sao Paulo,145,2,2,1,acept,2975,190,45,3210
Sao Paulo,125,3,4,5,acept,10000,666,151,10817
Rio de Janeiro,70,1,1,1,acept,2000,250,26,2276
Rio de Janeiro,90,2,2,1,not acept,2700,105,35,2840
Sao Paulo,28,1,1,0,acept,2500,22,32,2554
Campinas,110,3,3,2,acept,3200,88,49,3337
Belo Horizonte,165,3,3,3,acept,3000,192,50,3242
Sao Paulo,25,1,1,0,acept,1750,0,23,1773
Sao Paulo,195,4,3,4,acept,2700,1067,35,3802
Belo Horizonte,70,3,1,1,acept,900,1,12,913
Campinas,50,1,1,0,not acept,2000,100,26,2126
Sao Paulo,44,1,1,0,acept,2800,110,36,2946
Belo Horizonte,245,4,5,2,acept,2025,234,27,2286
Sao Paulo,46,2,1,0,acept,1700,0,22,1722
Belo Horizonte,70,2,1,1,acept,950,32,13,995
Rio de Janeiro,50,1,1,0,acept,750,0,10,760
Belo Horizonte,40,2,2,1,not acept,900,0,12,912
Sao Paulo,94,3,2,2,acept,2173,295,28,2496
Sao Paulo,323,3,5,6,acept,10000,985,151,11136
Rio de Janeiro,140,3,2,2,acept,7400,543,96,8039
Rio de Janeiro,102,3,2,1,acept,5000,38,65,5103
Sao Paulo,170,3,2,1,not acept,4500,263,58,4821
Belo Horizonte,250,4,2,2,acept,3500,0,47,3547
Sao Paulo,44,1,1,0,not acept,1200,30,16,1246
Sao Paulo,54,2,2,1,acept,2800,199,36,3035
Rio de Janeiro,125,4,4,2,acept,6130,217,79,6426
Sao Paulo,80,3,1,1,acept,2500,87,32,2619
Sao Paulo,150,3,2,4,acept,9670,55,146,9871
Belo Horizonte,50,2,1,1,acept,800,0,11,811
Sao Paulo,270,4,4,4,acept,8840,667,133,9640
Sao Paulo,53,1,1,1,not acept,3500,0,45,3545
Sao Paulo,486,8,4,6,acept,25000,2200,376,27576
Belo Horizonte,200,3,1,1,acept,3800,361,63,4224
Sao Paulo,218,3,3,3,acept,15000,809,191,16000
Sao Paulo,50,1,1,1,acept,1750,0,27,1777
Porto Alegre,112,2,2,2,acept,3153,100,47,3300
Campinas,300,4,5,4,acept,4000,362,61,4423
Belo Horizonte,75,2,1,2,acept,1500,63,25,1588
Sao Paulo,700,3,3,8,acept,13500,1210,203,14913
Sao Paulo,250,2,2,1,acept,4800,534,73,5407
Campinas,50,1,1,0,acept,940,50,15,1005
Rio de Janeiro,91,2,2,1,acept,9800,620,127,10547
Rio de Janeiro,83,2,1,1,acept,2330,74,31,2435
Sao Paulo,335,4,6,4,acept,4500,0,58,4558
Sao Paulo,520,4,4,3,acept,12000,1688,181,13869
Sao Paulo,235,3,2,2,acept,7200,626,92,7918
Sao Paulo,50,1,1,0,acept,1500,59,20,1579
Sao Paulo,280,5,5,4,acept,10000,1167,127,11294
Sao Paulo,80,1,1,1,not acept,1200,0,16,1216
Sao Paulo,70,2,2,1,acept,2100,9,27,2136
Sao Paulo,139,3,2,0,acept,8000,103,102,8205
Belo Horizonte,325,4,3,0,acept,9000,236,148,9384
Sao Paulo,60,2,1,1,acept,1100,0,14,1114
Porto Alegre,238,4,3,1,acept,4250,300,63,4613
Sao Paulo,50,1,1,0,not acept,1093,0,17,1110
Sao Paulo,128,3,3,0,acept,2900,226,37,3163
Sao Paulo,300,3,6,6,not acept,5000,1000,76,6076
Sao Paulo,160,3,3,1,acept,8000,0,121,8121
Belo Horizonte,400,5,5,8,acept,7900,513,130,8543
Rio de Janeiro,62,2,1,0,acept,1200,197,16,1413
Sao Paulo,300,4,5,2,acept,4200,250,64,4514
Sao Paulo,300,5,5,4,acept,4792,1500,61,6353
Campinas,30,1,1,0,not acept,1400,0,22,1422
Belo Horizonte,155,1,4,0,not acept,2790,64,38,2892
Sao Paulo,300,3,2,3,acept,3700,130,56,3886
Sao Paulo,37,1,1,1,acept,3700,0,47,3747
Sao Paulo,35,1,1,0,not acept,1500,309,20,1829
Porto Alegre,55,1,1,0,acept,700,32,11,743
Sao Paulo,50,1,1,0,acept,1550,25,20,1595
Sao Paulo,64,2,1,2,not acept,4000,342,51,4393
Sao Paulo,49,2,1,1,acept,2000,0,26,2026
Campinas,87,3,2,1,acept,1800,109,23,1932
Sao Paulo,250,3,4,2,acept,3480,360,53,3893
Sao Paulo,72,3,2,1,not acept,1750,3,23,1776
Sao Paulo,76,3,3,2,acept,2662,284,34,2980
Porto Alegre,163,3,4,2,acept,8000,217,117,8334
Sao Paulo,75,2,1,0,acept,4000,0,51,4051
Campinas,89,3,2,1,acept,1800,70,23,1893
Sao Paulo,93,3,3,2,acept,4200,267,54,4521
Sao Paulo,420,3,6,4,not acept,6500,0,98,6598
Belo Horizonte,640,6,7,5,acept,6141,667,101,6909
Sao Paulo,326,3,4,5,acept,15000,3000,191,18191
Sao Paulo,136,3,4,3,not acept,3500,350,45,3895
Porto Alegre,39,1,1,0,acept,780,8,12,800
Belo Horizonte,70,2,1,1,acept,900,0,8,908
Sao Paulo,480,4,6,5,acept,15000,1572,226,16798
Sao Paulo,50,2,1,0,acept,1900,42,25,1967
Sao Paulo,180,3,3,5,acept,2500,232,38,2770
Belo Horizonte,100,3,2,2,acept,3000,371,40,3411
Belo Horizonte,100,3,2,1,acept,2000,74,33,2107
Sao Paulo,560,5,5,6,acept,15000,1917,226,17143
Sao Paulo,180,5,3,2,not acept,9000,0,136,9136
Rio de Janeiro,44,1,1,0,acept,2350,67,31,2448
Sao Paulo,18,1,1,1,not acept,1090,84,14,1188
Campinas,154,2,2,1,acept,1300,109,20,1429
Sao Paulo,80,2,2,1,not acept,2800,334,36,3170
Belo Horizonte,308,2,3,3,acept,2000,171,33,2204
Sao Paulo,150,4,4,1,acept,4500,615,68,5183
Sao Paulo,80,2,2,2,acept,2450,250,32,2732
Sao Paulo,70,2,1,1,acept,1000,138,13,1151
Sao Paulo,136,3,2,1,acept,4000,250,51,4301
Porto Alegre,55,1,1,1,acept,935,45,14,994
Porto Alegre,90,3,2,1,acept,2200,60,33,2293
Campinas,48,2,1,1,acept,1545,49,20,1614
Sao Paulo,224,4,5,3,acept,9500,1650,121,11271
Porto Alegre,32,1,1,1,acept,2500,42,37,2579
Rio de Janeiro,60,2,1,1,acept,500,47,7,554
Rio de Janeiro,150,3,2,1,acept,4200,234,55,4489
Sao Paulo,260,3,5,3,acept,4500,134,58,4692
Sao Paulo,42,1,1,0,acept,1120,34,14,1168
Belo Horizonte,320,4,3,3,not acept,7000,600,94,7694
Porto Alegre,460,4,4,4,acept,4000,270,72,4342
Sao Paulo,208,3,3,3,acept,5960,641,76,6677
Sao Paulo,360,4,5,4,acept,6593,1830,84,8507
Sao Paulo,30,1,1,0,not acept,1500,25,20,1545
Sao Paulo,132,2,2,0,acept,2900,0,37,2937
Belo Horizonte,250,6,6,2,acept,9000,495,148,9643
Sao Paulo,29,1,1,1,not acept,3050,200,39,3289
Sao Paulo,100,1,2,2,acept,2000,84,31,2115
Rio de Janeiro,100,3,2,1,acept,1920,217,25,2162
Porto Alegre,120,3,3,0,acept,7500,284,110,7894
Belo Horizonte,390,6,3,2,acept,11000,417,181,11598
Sao Paulo,80,3,1,0,acept,2400,60,37,2497
Sao Paulo,140,3,3,1,acept,3000,59,39,3098
Sao Paulo,146,3,2,2,acept,3500,600,45,4145
Belo Horizonte,360,4,2,4,acept,6000,189,99,6288
Sao Paulo,165,3,3,4,acept,5000,584,64,5648
Sao Paulo,100,3,2,2,acept,3570,63,54,3687
Sao Paulo,80,3,2,2,acept,3100,90,40,3230
Sao Paulo,29,1,1,0,acept,2300,25,30,2355
Campinas,46,1,1,1,not acept,935,45,12,992
Sao Paulo,110,3,2,2,not acept,5500,341,70,5911
Sao Paulo,300,3,3,3,acept,3400,417,52,3869
Sao Paulo,62,2,2,3,acept,7000,384,89,7473
Sao Paulo,150,3,1,0,not acept,4200,12,54,4266
Porto Alegre,92,3,1,0,acept,1800,42,27,1869
Belo Horizonte,50,2,1,1,acept,900,0,12,912
Sao Paulo,220,3,3,3,acept,8900,1466,113,10479
Rio de Janeiro,250,4,3,2,acept,5300,852,69,6221
Rio de Janeiro,160,3,2,1,acept,4000,417,52,4469
Rio de Janeiro,110,3,2,1,acept,2500,309,33,2842
Sao Paulo,120,4,4,4,acept,4000,0,61,4061
Porto Alegre,101,3,2,1,acept,2900,142,43,3085
Sao Paulo,60,2,1,0,not acept,1800,0,23,1823
Sao Paulo,60,2,1,1,not acept,1700,23,26,1749
Sao Paulo,330,4,3,0,acept,10000,1084,127,11211
Sao Paulo,350,3,6,4,acept,12000,1417,153,13570
Rio de Janeiro,26,1,1,0,acept,2100,167,28,2295
Sao Paulo,110,4,5,3,acept,3900,625,59,4584
Sao Paulo,233,3,4,4,not acept,4300,2567,55,6922
Belo Horizonte,441,5,5,8,acept,8000,553,132,8685
Porto Alegre,44,1,1,0,acept,550,6,9,565
Sao Paulo,150,3,4,3,acept,4600,500,70,5170
Sao Paulo,50,1,1,0,acept,820,8,13,841
Belo Horizonte,136,4,3,1,acept,2300,72,31,2403
Sao Paulo,455,3,2,4,acept,11000,1834,166,13000
Belo Horizonte,160,4,4,3,not acept,6500,696,87,7283
Sao Paulo,58,1,1,2,acept,2000,0,26,2026
Porto Alegre,75,2,1,0,acept,2500,100,37,2637
Rio de Janeiro,160,3,2,1,acept,3150,3700,41,6891
Sao Paulo,310,5,2,2,acept,5000,1084,64,6148
Sao Paulo,180,3,2,2,acept,2500,542,32,3074
Sao Paulo,207,3,4,3,acept,2500,817,32,3349
Sao Paulo,91,3,3,3,not acept,2438,850,31,3319
Sao Paulo,275,4,3,4,acept,10000,0,127,10127
Sao Paulo,265,4,6,3,not acept,2500,1284,32,3816
Sao Paulo,57,1,1,1,acept,6000,17,77,6094
Porto Alegre,450,5,5,2,acept,8000,417,143,8560
Sao Paulo,245,4,5,4,acept,3200,744,41,3985
Sao Paulo,216,3,4,2,acept,4675,870,60,5605
Campinas,74,3,2,1,acept,900,24,12,936
Sao Paulo,80,2,1,1,acept,2300,94,30,2424
Sao Paulo,130,3,2,2,acept,3850,209,49,4108
Porto Alegre,56,1,2,1,acept,2500,100,37,2637
Sao Paulo,163,2,3,3,acept,7000,896,89,7985
Porto Alegre,70,2,1,0,acept,1200,34,18,1252
Campinas,45,1,1,0,acept,860,66,11,937
Sao Paulo,80,1,2,0,not acept,3900,135,50,4085
Sao Paulo,80,2,1,0,not acept,1950,0,25,1975
Sao Paulo,600,3,3,4,acept,6800,966,103,7869
Belo Horizonte,150,3,2,2,acept,1600,108,22,1730
Belo Horizonte,28,1,1,1,not acept,1250,0,17,1267
Sao Paulo,265,3,3,2,acept,8712,1167,131,10010
Belo Horizonte,100,4,2,2,acept,2840,369,47,3256
Campinas,55,1,1,1,not acept,1100,30,14,1144
Campinas,48,2,1,1,acept,850,0,11,861
Rio de Janeiro,82,2,2,0,acept,3000,232,39,3271
Belo Horizonte,140,4,3,3,acept,3300,292,44,3636
Belo Horizonte,360,5,6,4,acept,12000,329,197,12526
Sao Paulo,35,1,1,0,acept,1200,0,16,1216
Porto Alegre,72,2,2,1,acept,950,100,14,1064
Belo Horizonte,133,3,2,3,not acept,2100,161,28,2289
Porto Alegre,95,3,1,2,acept,1300,96,19,1415
Porto Alegre,27,1,1,0,acept,960,75,15,1050
Sao Paulo,30,1,1,1,not acept,3500,0,45,3545
Belo Horizonte,350,5,5,3,not acept,2000,252,27,2279
Sao Paulo,179,3,3,3,acept,3200,900,41,4141
Porto Alegre,65,3,2,1,acept,850,24,13,887
Rio de Janeiro,150,4,3,2,acept,5000,717,77,5794
Sao Paulo,35,1,1,0,not acept,1310,0,17,1327
Porto Alegre,47,1,1,1,not acept,2200,0,33,2233
Belo Horizonte,360,6,3,4,acept,7000,1108,115,8223
Sao Paulo,115,2,2,1,acept,6500,125,83,6708
Sao Paulo,341,3,3,2,acept,4400,825,56,5281
Porto Alegre,89,2,2,1,acept,1850,0,28,1878
Rio de Janeiro,46,1,1,0,acept,2350,131,31,2512
Sao Paulo,226,3,4,3,acept,6900,1209,88,8197
Rio de Janeiro,32,1,1,0,acept,1430,62,19,1511
Sao Paulo,115,2,3,2,acept,12000,790,153,12943
Porto Alegre,164,3,3,0,acept,4500,225,66,4791
Sao Paulo,37,1,1,1,acept,3000,125,39,3164
Sao Paulo,160,3,2,2,acept,4000,267,61,4328
Sao Paulo,175,4,3,2,acept,3200,380,49,3629
Belo Horizonte,140,3,2,1,not acept,3300,184,44,3528
Sao Paulo,400,4,6,5,acept,5300,984,80,6364
Sao Paulo,45,1,2,0,acept,1430,0,22,1452
Belo Horizonte,153,4,2,2,acept,3500,426,47,3973
Campinas,56,2,1,1,acept,760,11,10,781
Sao Paulo,383,4,5,6,acept,9500,1760,143,11403
Sao Paulo,146,3,4,2,acept,11000,592,140,11732
Sao Paulo,135,3,2,0,acept,4500,317,58,4875
Sao Paulo,37,1,1,1,not acept,3000,112,39,3151
Sao Paulo,238,3,5,3,acept,15000,834,191,16025
Sao Paulo,55,1,1,0,acept,1100,0,14,1114
Sao Paulo,92,2,2,2,acept,2288,244,29,2561
Porto Alegre,215,6,6,6,acept,5000,109,89,5198
Porto Alegre,320,4,4,2,acept,4500,2900,66,7466
Campinas,64,1,2,1,not acept,1540,68,20,1628
Belo Horizonte,92,2,2,2,acept,5000,67,67,5134
Rio de Janeiro,72,2,1,1,acept,800,15,11,826
Rio de Janeiro,65,1,1,0,acept,2200,30,29,2259
Rio de Janeiro,500,5,5,2,acept,8000,459,104,8563
Sao Paulo,131,4,4,2,acept,4500,317,58,4875
Sao Paulo,70,3,2,2,acept,2500,120,32,2652
Sao Paulo,530,4,6,4,acept,2569,2417,33,5019
Belo Horizonte,85,3,3,2,not acept,1750,165,24,1939
Sao Paulo,20,1,1,0,acept,1800,130,23,1953
Sao Paulo,139,3,4,2,not acept,11000,500,140,11640
Sao Paulo,45,1,1,1,not acept,5520,0,70,5590
Belo Horizonte,266,4,3,2,acept,7500,236,123,7859
Belo Horizonte,110,3,2,4,acept,2100,145,35,2280
Sao Paulo,182,3,4,3,acept,7000,459,106,7565
Sao Paulo,318,4,6,4,not acept,12000,334,153,12487
Sao Paulo,380,4,6,1,not acept,10840,334,163,11337
Rio de Janeiro,85,2,3,0,acept,1940,167,25,2132
Porto Alegre,62,2,1,0,acept,1250,40,19,1309
Rio de Janeiro,42,1,1,0,acept,1300,42,17,1359
Sao Paulo,50,2,2,1,acept,1900,0,25,1925
Belo Horizonte,52,2,1,1,acept,860,61,12,933
Sao Paulo,179,4,4,3,acept,8500,751,108,9359
Rio de Janeiro,100,2,3,0,acept,2662,373,35,3070
Rio de Janeiro,80,2,2,1,acept,2500,119,33,2652
Sao Paulo,180,3,1,1,acept,2500,84,38,2622
Porto Alegre,650,4,6,5,acept,13800,650,246,14696
Porto Alegre,51,1,1,1,acept,2000,61,30,2091
Campinas,48,2,1,1,not acept,1400,27,18,1445
Rio de Janeiro,350,4,4,2,acept,9000,833,116,9949
Sao Paulo,354,5,6,3,acept,8850,958,134,9942
Sao Paulo,250,4,5,0,acept,12000,1584,153,13737
Sao Paulo,55,2,2,1,acept,1300,67,17,1384
Sao Paulo,60,2,2,1,acept,3800,130,49,3979
Sao Paulo,350,4,3,4,acept,7300,600,110,8010
Rio de Janeiro,70,3,2,0,acept,1500,50,20,1570
Belo Horizonte,150,4,2,1,acept,2250,9,37,2296
Sao Paulo,32,1,1,0,acept,2001,0,26,2027
Rio de Janeiro,50,1,1,0,not acept,2960,200,39,3199
Belo Horizonte,744,6,6,8,acept,11000,3000,181,14181
Belo Horizonte,26,1,1,1,acept,750,67,10,827
Sao Paulo,63,2,2,1,acept,3500,113,45,3658
Sao Paulo,60,2,1,0,acept,1600,0,21,1621
Sao Paulo,120,3,2,1,acept,3280,125,42,3447
Rio de Janeiro,47,2,1,1,acept,1000,0,13,1013
Campinas,93,3,2,2,acept,1700,73,22,1795
Sao Paulo,92,3,2,0,acept,5800,242,74,6116
Porto Alegre,84,3,2,1,acept,2200,77,33,2310
Sao Paulo,100,2,2,1,not acept,1450,80,22,1552
Campinas,380,4,6,6,not acept,4100,269,62,4431
Sao Paulo,130,3,2,1,acept,2900,200,37,3137
Sao Paulo,200,3,3,2,not acept,6000,125,77,6202
Sao Paulo,33,1,1,1,not acept,2000,250,26,2276
Sao Paulo,100,3,1,0,acept,2200,350,34,2584
Sao Paulo,115,2,1,0,acept,2200,67,28,2295
Sao Paulo,327,4,4,5,acept,7000,2662,89,9751
Belo Horizonte,45,2,1,1,acept,880,0,12,892
Porto Alegre,124,3,3,1,acept,1942,68,29,2039
Sao Paulo,64,1,2,1,acept,8900,154,64,9118
Belo Horizonte,212,4,2,1,acept,2100,250,28,2378
Sao Paulo,100,2,3,2,acept,2200,209,28,2437
Sao Paulo,38,1,1,1,acept,3008,0,39,3047
Sao Paulo,330,3,5,5,acept,7500,1400,96,8996
Sao Paulo,71,2,1,1,acept,2140,0,28,2168
Sao Paulo,70,2,2,1,not acept,4500,122,58,4680
Sao Paulo,220,4,3,3,acept,3400,0,44,3444
Sao Paulo,128,3,2,2,acept,2500,293,32,2825
Sao Paulo,35,1,1,1,acept,4900,70,63,5033
Porto Alegre,220,4,3,1,not acept,2000,0,36,2036
Sao Paulo,380,4,6,6,acept,12000,3000,153,15153
Sao Paulo,43,2,1,1,not acept,1375,17,18,1410
Sao Paulo,60,1,1,0,acept,1250,280,16,1546
Rio de Janeiro,53,1,1,0,acept,1700,74,22,1796
Sao Paulo,50,2,1,1,acept,3900,71,50,4021
Sao Paulo,65,2,2,0,acept,1910,0,25,1935
Sao Paulo,150,3,2,1,acept,1450,0,22,1472
Belo Horizonte,70,3,1,0,acept,970,85,13,1068
Sao Paulo,49,1,1,1,acept,6200,0,79,6279
Sao Paulo,30,1,1,0,not acept,1200,0,19,1219
Sao Paulo,45,1,1,0,acept,1275,0,17,1292
Porto Alegre,260,2,2,1,acept,2000,25,30,2055
Porto Alegre,32,1,1,1,acept,2500,42,37,2579
Sao Paulo,197,3,4,1,acept,4500,459,58,5017
Rio de Janeiro,500,2,5,5,not acept,1810,54,28,1892
Sao Paulo,136,3,3,2,acept,2200,339,28,2567
Belo Horizonte,120,4,4,2,acept,3000,493,40,3533
Sao Paulo,115,3,2,1,acept,6300,224,80,6604
Sao Paulo,130,2,1,1,acept,3850,160,49,4059
Sao Paulo,87,3,3,2,not acept,3000,253,39,3292
Sao Paulo,95,3,2,0,acept,2350,0,36,2386
Campinas,70,1,2,1,not acept,1500,184,20,1704
Rio de Janeiro,87,2,2,1,acept,3500,249,46,3795
Belo Horizonte,50,1,1,0,not acept,1050,39,18,1107
Sao Paulo,50,1,1,1,acept,3500,213,45,3758
Sao Paulo,128,3,4,2,not acept,5000,609,64,5673
Rio de Janeiro,86,3,2,1,acept,3300,228,43,3571
Sao Paulo,100,3,2,1,not acept,2700,71,35,2806
Sao Paulo,139,4,5,2,not acept,10000,584,127,10711
Campinas,72,2,1,0,not acept,780,60,10,850
Belo Horizonte,120,3,3,3,acept,2650,434,36,3120
Sao Paulo,24,1,1,0,not acept,2530,55,33,2618
Campinas,135,2,2,2,acept,3800,255,49,4104
Sao Paulo,280,3,4,4,acept,5450,1042,70,6562
Sao Paulo,49,1,1,1,not acept,5400,0,69,5469
Sao Paulo,40,1,1,0,not acept,2600,0,33,2633
Sao Paulo,320,3,3,4,acept,8000,1167,121,9288
Sao Paulo,52,1,1,1,not acept,4420,188,57,4665
Sao Paulo,20,1,1,0,not acept,600,40,8,648
Sao Paulo,240,3,3,4,acept,12000,1975,153,14128
Porto Alegre,109,3,2,1,acept,2080,167,31,2278
Sao Paulo,119,3,3,1,not acept,3750,135,48,3933
Sao Paulo,340,4,6,4,acept,2800,1667,36,4503
Sao Paulo,790,4,4,2,acept,10000,2500,151,12651
Sao Paulo,35,1,1,0,acept,1618,29,21,1668
Sao Paulo,98,3,3,2,acept,2900,459,37,3396
Sao Paulo,260,4,4,4,acept,4000,600,51,4651
Sao Paulo,45,2,1,0,not acept,1610,8,21,1639
Sao Paulo,270,2,2,3,acept,8650,0,110,8760
Sao Paulo,50,1,1,0,acept,1400,1,22,1423
Rio de Janeiro,30,1,1,1,acept,900,60,12,972
Sao Paulo,45,2,1,1,acept,1100,38,14,1152
Sao Paulo,150,3,1,2,acept,3000,0,39,3039
Porto Alegre,42,1,1,1,acept,1390,54,21,1465
Sao Paulo,210,3,4,3,acept,13000,1417,165,14582
Sao Paulo,58,2,1,0,acept,1780,0,23,1803
Campinas,76,2,2,2,acept,3100,146,40,3286
Porto Alegre,28,1,1,0,acept,850,12,13,875
Sao Paulo,130,2,4,4,not acept,2700,411,35,3146
Sao Paulo,60,1,1,0,not acept,1300,144,20,1464
Sao Paulo,54,2,1,1,not acept,1460,0,19,1479
Sao Paulo,111,3,3,2,acept,4000,357,61,4418
Belo Horizonte,80,2,3,2,acept,2800,350,38,3188
Sao Paulo,600,6,5,5,acept,12000,3334,181,15515
Porto Alegre,73,2,1,1,acept,1200,39,18,1257
Rio de Janeiro,80,2,2,1,acept,5000,395,65,5460
Sao Paulo,145,3,3,1,acept,5800,375,74,6249
Sao Paulo,42,1,1,1,acept,2700,52,35,2787
Sao Paulo,98,2,1,1,acept,1800,8,23,1831
Porto Alegre,80,3,2,2,acept,1850,50,28,1928
Porto Alegre,367,4,3,2,acept,4500,309,66,4875
Porto Alegre,68,2,2,2,acept,2400,100,20,2520
Porto Alegre,90,3,2,1,acept,1480,79,22,1581
Rio de Janeiro,154,4,5,2,acept,10000,750,129,10879
Porto Alegre,47,2,1,1,acept,1200,0,18,1218
Sao Paulo,230,5,3,2,acept,3491,291,53,3835
Rio de Janeiro,180,3,3,1,acept,2910,459,38,3407
Rio de Janeiro,120,3,2,1,acept,4500,219,58,4777
Belo Horizonte,110,3,2,0,acept,1600,93,22,1715
Sao Paulo,450,4,6,4,acept,11600,1042,175,12817
Belo Horizonte,400,7,6,4,acept,6800,234,112,7146
Rio de Janeiro,25,1,1,0,not acept,2718,17,36,2771
Sao Paulo,62,1,2,1,acept,11000,262,140,11402
Sao Paulo,95,2,1,1,acept,3000,67,39,3106
Belo Horizonte,110,3,3,2,acept,2200,220,30,2450
Rio de Janeiro,140,3,2,1,acept,2200,95,29,2324
Sao Paulo,34,1,1,1,not acept,2890,0,37,2927
Sao Paulo,22,1,1,1,not acept,3000,8,39,3047
Sao Paulo,177,3,3,3,not acept,8500,1250,108,9858
Sao Paulo,96,2,1,1,acept,4300,118,55,4473
Campinas,100,2,2,0,acept,1700,200,26,1926
Sao Paulo,68,2,2,1,acept,2600,196,33,2829
Sao Paulo,300,3,5,4,acept,4490,334,68,4892
Rio de Janeiro,160,3,2,1,acept,3000,256,39,3295
Sao Paulo,140,3,2,2,acept,2000,51,31,2082
Sao Paulo,136,4,2,3,acept,3300,250,42,3592
Sao Paulo,65,2,2,2,not acept,3500,0,45,3545
Belo Horizonte,200,3,6,4,acept,4000,731,54,4785
Porto Alegre,120,3,3,2,acept,3240,100,48,3388
Rio de Janeiro,62,2,1,0,acept,3000,212,39,3251
Sao Paulo,390,3,3,2,not acept,6500,1000,83,7583
Sao Paulo,67,2,1,0,acept,1200,0,16,1216
Sao Paulo,52,1,1,1,acept,4667,64,60,4791
Sao Paulo,39,1,1,1,acept,2500,312,32,2844
Sao Paulo,270,3,3,4,acept,3200,1667,41,4908
Sao Paulo,82,3,2,2,acept,1800,290,23,2113
Sao Paulo,200,2,4,3,acept,12500,1335,159,13994
Sao Paulo,33,1,1,0,acept,1500,0,20,1520
Sao Paulo,110,3,2,2,acept,5500,297,70,5867
Sao Paulo,70,3,1,1,acept,3000,0,39,3039
Sao Paulo,93,3,3,2,acept,3750,359,48,4157
Rio de Janeiro,65,1,1,0,acept,1800,30,24,1854
Sao Paulo,280,4,5,4,not acept,12000,917,153,13070
Belo Horizonte,130,4,2,2,acept,2350,274,32,2656
Sao Paulo,100,2,2,1,not acept,4550,75,69,4694
Porto Alegre,40,1,1,0,not acept,1200,0,18,1218
Sao Paulo,140,3,4,2,not acept,3000,234,39,3273
Belo Horizonte,170,4,2,2,acept,4000,297,54,4351
Sao Paulo,110,2,1,1,not acept,1800,0,23,1823
Belo Horizonte,45,1,1,1,acept,1500,130,20,1650
Belo Horizonte,275,5,4,2,acept,9000,646,148,9794
Rio de Janeiro,46,1,1,0,acept,1200,196,16,1412
Sao Paulo,98,2,3,2,acept,8500,468,108,9076
Sao Paulo,120,3,1,4,acept,3500,260,53,3813
Sao Paulo,180,3,2,1,acept,7000,299,89,7388
Sao Paulo,250,4,3,3,acept,4000,167,51,4218
Campinas,85,3,2,1,not acept,1690,63,22,1775
Sao Paulo,126,3,4,3,acept,4000,1021,51,5072
Sao Paulo,132,3,4,2,acept,3200,317,41,3558
Porto Alegre,216,3,3,3,acept,2390,94,43,2527
Sao Paulo,54,2,1,1,acept,1200,84,16,1300
Porto Alegre,160,2,4,2,not acept,3100,200,46,3346
Sao Paulo,62,3,1,1,not acept,1600,25,21,1646
Rio de Janeiro,270,4,3,1,not acept,4000,1000,52,5052
Sao Paulo,145,3,4,3,not acept,2850,459,37,3346
Porto Alegre,63,2,1,0,acept,1170,34,18,1222
Rio de Janeiro,115,2,2,1,not acept,8500,625,110,9235
Campinas,51,1,1,0,not acept,680,15,9,704
Rio de Janeiro,70,3,1,1,acept,1200,71,16,1287
Sao Paulo,165,3,4,6,acept,4800,100,73,4973
Sao Paulo,208,4,5,2,acept,7000,792,89,7881
Sao Paulo,87,3,2,1,acept,3600,93,46,3739
Belo Horizonte,90,3,2,0,not acept,1400,136,19,1555
Sao Paulo,300,2,4,2,acept,3250,0,49,3299
Sao Paulo,200,3,2,3,acept,3950,800,60,4810
Rio de Janeiro,65,2,1,0,not acept,2950,192,39,3181
Belo Horizonte,42,1,1,1,not acept,2690,172,36,2898
Porto Alegre,42,1,1,2,acept,1000,80,15,1095
Rio de Janeiro,28,1,1,0,acept,1300,42,17,1359
Sao Paulo,140,2,3,2,acept,4000,250,51,4301
Sao Paulo,53,2,2,1,not acept,3000,89,39,3128
Sao Paulo,120,3,2,2,acept,2000,323,31,2354
Rio de Janeiro,100,3,2,1,acept,3000,324,39,3363
Porto Alegre,360,3,1,4,acept,2800,417,50,3267
Sao Paulo,227,4,4,3,acept,9000,1417,115,10532
Rio de Janeiro,30,1,1,0,acept,1380,0,18,1398
Sao Paulo,90,2,2,1,acept,2968,67,38,3073
Sao Paulo,110,4,4,1,acept,6800,167,103,7070
Sao Paulo,400,3,3,4,acept,4250,160,64,4474
Rio de Janeiro,49,1,1,0,acept,2190,155,29,2374
Sao Paulo,100,3,3,1,acept,7000,881,106,7987
Sao Paulo,83,3,1,1,acept,2500,0,32,2532
Porto Alegre,40,1,1,0,acept,1250,6,19,1275
Sao Paulo,311,4,4,4,acept,15000,0,191,15191
Belo Horizonte,120,4,2,2,acept,3000,397,50,3447
Sao Paulo,67,2,1,1,acept,1800,0,23,1823
Sao Paulo,100,2,2,0,acept,2700,265,35,3000
Belo Horizonte,100,2,1,0,not acept,1096,59,15,1170
Sao Paulo,301,3,4,4,acept,8000,2917,121,11038
Rio de Janeiro,86,3,2,1,acept,2630,201,34,2865
Rio de Janeiro,45,1,1,0,not acept,2500,75,33,2608
Sao Paulo,55,2,1,1,not acept,1330,0,17,1347
Porto Alegre,63,2,1,0,acept,1000,42,15,1057
Sao Paulo,220,3,4,2,acept,4500,197,68,4765
Belo Horizonte,202,3,2,5,acept,5500,285,91,5876
Rio de Janeiro,85,2,1,0,acept,3420,209,45,3674
Porto Alegre,80,2,2,1,acept,3300,50,49,3399
Sao Paulo,400,4,4,4,acept,10000,912,151,11063
Belo Horizonte,400,5,4,4,acept,5500,167,91,5758
Sao Paulo,22,1,1,0,acept,1650,0,21,1671
Campinas,128,3,3,2,acept,3700,117,47,3864
Campinas,170,2,3,3,acept,5900,167,75,6142
Belo Horizonte,55,2,1,1,not acept,850,81,12,943
Campinas,51,1,1,0,acept,740,15,10,765
Porto Alegre,50,2,1,1,acept,1440,0,22,1462
Rio de Janeiro,81,2,1,0,acept,1600,90,21,1711
Sao Paulo,40,1,1,0,not acept,1100,50,14,1164
Porto Alegre,83,2,2,1,acept,2500,101,37,2638
Sao Paulo,420,4,6,4,not acept,14000,1417,178,15595
Sao Paulo,204,4,3,1,acept,6000,0,77,6077
Sao Paulo,240,2,2,4,acept,3500,362,53,3915
Sao Paulo,56,2,1,1,acept,1160,0,15,1175
Porto Alegre,82,2,2,2,acept,4150,200,61,4411
Belo Horizonte,327,4,4,2,acept,8799,563,145,9507
Sao Paulo,96,1,2,1,acept,4250,167,54,4471
Sao Paulo,54,1,1,0,acept,2306,0,30,2336
Porto Alegre,41,1,1,1,acept,2100,17,31,2148
Porto Alegre,218,3,5,2,acept,4950,409,73,5432
Rio de Janeiro,20,1,1,0,acept,2150,0,28,2178
Sao Paulo,170,4,4,3,not acept,5000,750,22,5772
Sao Paulo,250,3,3,0,acept,2500,1336,32,3868
Sao Paulo,40,1,1,0,acept,1100,195,17,1312
Sao Paulo,400,4,6,4,acept,10000,2050,127,12177
Sao Paulo,350,5,4,6,acept,6000,640,91,6731
Campinas,94,3,1,1,acept,2000,60,26,2086
Sao Paulo,30,1,1,0,not acept,850,67,13,930
Sao Paulo,142,3,3,2,acept,9000,475,115,9590
Rio de Janeiro,177,3,3,4,acept,6900,509,89,7498
Belo Horizonte,126,4,2,2,acept,2550,168,34,2752
Porto Alegre,160,3,2,2,acept,1990,50,30,2070
Sao Paulo,54,1,1,0,acept,1500,0,20,1520
Sao Paulo,20,1,1,0,not acept,3142,67,40,3249
Sao Paulo,75,2,2,0,not acept,2125,146,27,2298
Rio de Janeiro,60,2,1,0,acept,1100,86,15,1201
Belo Horizonte,150,4,4,2,acept,3350,359,45,3754
Sao Paulo,156,3,3,3,acept,8000,628,102,8730
Sao Paulo,206,3,3,1,acept,7400,586,94,8080
Sao Paulo,100,2,1,0,not acept,1659,0,22,1681
Porto Alegre,47,1,1,1,not acept,940,5,14,959
Sao Paulo,220,3,4,4,not acept,3550,790,45,4385
Sao Paulo,60,2,1,1,acept,1650,0,21,1671
Porto Alegre,457,6,6,2,acept,8500,417,152,9069
Sao Paulo,340,4,4,5,acept,7000,1660,89,8749
Rio de Janeiro,93,3,2,2,acept,4950,286,64,5300
Sao Paulo,200,3,2,5,acept,7000,963,106,8069
Sao Paulo,340,4,5,4,acept,8000,1334,102,9436
Rio de Janeiro,108,3,2,1,acept,5200,252,68,5520
Sao Paulo,240,3,5,6,acept,4900,100,74,5074
Rio de Janeiro,82,2,2,1,acept,1950,79,26,2055
Rio de Janeiro,480,4,7,3,not acept,6500,115,84,6699
Belo Horizonte,35,1,1,1,not acept,700,0,10,710
Porto Alegre,105,4,2,1,acept,2200,114,33,2347
Sao Paulo,66,1,1,2,acept,2800,200,36,3036
Sao Paulo,85,2,1,1,acept,1450,0,22,1472
Porto Alegre,45,2,1,1,acept,750,67,11,828
Sao Paulo,50,1,1,1,not acept,3500,100,45,3645
Sao Paulo,30,4,4,2,acept,5000,4247,76,9323
Sao Paulo,450,3,2,0,acept,5800,917,88,6805
Porto Alegre,52,1,1,1,acept,2500,1,37,2538
Sao Paulo,235,3,2,1,acept,6000,825,91,6916
Sao Paulo,141,3,3,2,acept,7935,167,101,8203
Sao Paulo,80,2,1,0,acept,1200,67,19,1286
Belo Horizonte,247,4,2,1,acept,2600,264,43,2907
Sao Paulo,49,2,1,1,acept,2100,104,27,2231
Sao Paulo,325,4,5,4,acept,15000,2209,191,17400
Sao Paulo,200,3,3,4,acept,3230,680,41,3951
Belo Horizonte,220,3,4,3,acept,8000,625,107,8732
Rio de Janeiro,170,3,1,1,not acept,5000,5404,65,10469
Sao Paulo,46,2,1,0,acept,2880,27,37,2944
Porto Alegre,63,2,1,0,acept,1400,53,21,1474
Sao Paulo,160,4,4,3,acept,11000,0,140,11140
Sao Paulo,100,2,1,1,acept,3800,270,58,4128
Sao Paulo,23,1,1,0,acept,2100,42,27,2169
Sao Paulo,35,1,1,1,not acept,1250,0,16,1266
Sao Paulo,120,3,2,1,acept,5300,167,68,5535
Sao Paulo,150,3,4,3,acept,5120,834,65,6019
Sao Paulo,220,3,4,2,acept,7000,434,106,7540
Sao Paulo,48,2,1,1,not acept,2050,104,26,2180
Campinas,45,1,1,1,acept,1320,28,17,1365
Sao Paulo,160,3,3,2,acept,4680,212,71,4963
Campinas,46,1,1,0,acept,850,15,11,876
Porto Alegre,34,1,1,1,acept,1500,6,22,1528
Belo Horizonte,540,5,4,8,acept,7000,912,115,8027
Sao Paulo,171,3,3,4,not acept,8700,820,111,9631
Sao Paulo,30,1,1,0,not acept,700,59,11,770
Belo Horizonte,118,3,2,0,not acept,1500,71,20,1591
Sao Paulo,80,2,2,2,acept,1850,45,24,1919
Sao Paulo,55,1,2,1,acept,5500,18,70,5588
Sao Paulo,55,2,1,1,acept,1200,122,19,1341
Sao Paulo,380,3,2,2,acept,6650,667,85,7402
Belo Horizonte,300,3,4,2,not acept,7000,84,115,7199
Sao Paulo,100,3,2,2,not acept,2000,0,26,2026
Sao Paulo,180,3,3,3,acept,5000,235,76,5311
Sao Paulo,300,4,5,4,acept,7000,1417,89,8506
Porto Alegre,193,3,2,2,acept,2400,297,36,2733
Sao Paulo,110,2,2,0,acept,4750,146,61,4957
Rio de Janeiro,20,1,1,0,not acept,720,50,10,780
Rio de Janeiro,300,3,4,1,acept,8300,917,107,9324
Sao Paulo,52,1,2,1,acept,4100,116,52,4268
Rio de Janeiro,120,2,3,2,acept,1935,81,25,2041
Sao Paulo,97,3,2,2,acept,1700,125,22,1847
Sao Paulo,58,2,1,1,acept,1200,0,16,1216
Sao Paulo,343,4,4,4,acept,6000,1042,91,7133
Sao Paulo,205,4,4,6,acept,2720,959,35,3714
Sao Paulo,68,3,2,1,acept,1500,84,20,1604
Sao Paulo,67,3,2,1,acept,1700,180,22,1902
Rio de Janeiro,40,1,1,0,acept,5000,72,65,5137
Sao Paulo,62,3,1,1,acept,1200,0,16,1216
Sao Paulo,120,5,2,4,acept,6500,680,98,7278
Sao Paulo,50,2,1,1,acept,1400,0,18,1418
Porto Alegre,40,1,1,0,acept,500,140,8,648
Sao Paulo,22,1,1,0,not acept,700,5,9,714
Sao Paulo,110,3,3,1,acept,4700,138,60,4898
Rio de Janeiro,80,2,1,1,acept,680,48,9,737
Sao Paulo,224,3,4,2,acept,6000,679,77,6756
Sao Paulo,93,2,1,2,not acept,6800,460,87,7347
Sao Paulo,45,1,1,0,not acept,1050,34,16,1100
Sao Paulo,120,3,2,1,acept,2500,347,32,2879
Campinas,73,3,2,2,acept,2000,204,26,2230
Sao Paulo,50,2,1,1,not acept,1600,0,21,1621
Sao Paulo,136,4,3,1,acept,4200,312,54,4566
Sao Paulo,235,3,4,4,acept,15000,1150,191,16341
Porto Alegre,110,3,3,0,acept,3250,75,48,3373
Sao Paulo,400,4,6,1,not acept,4000,2650,51,6701
Sao Paulo,220,3,3,3,acept,2800,250,43,3093
Rio de Janeiro,82,2,2,1,acept,2000,102,26,2128
Sao Paulo,100,3,3,2,acept,2800,384,36,3220
Sao Paulo,250,4,4,4,acept,15000,1250,191,16441
Belo Horizonte,90,2,3,1,acept,3760,280,51,4091
Sao Paulo,47,1,1,0,not acept,1000,76,13,1089
Sao Paulo,35,1,1,0,not acept,1080,35,14,1129
Rio de Janeiro,150,2,1,0,acept,1500,180,20,1700
Sao Paulo,69,2,1,0,acept,7540,380,96,8016
Campinas,38,1,1,1,acept,740,30,10,780
Sao Paulo,62,2,2,2,acept,1720,120,22,1862
Sao Paulo,100,2,2,0,acept,2500,220,38,2758
Sao Paulo,300,3,5,3,acept,5780,1250,74,7104
Sao Paulo,160,3,3,1,acept,4500,450,58,5008
Campinas,55,1,1,1,not acept,2000,9,26,2035
Sao Paulo,61,2,1,1,not acept,3300,216,42,3558
Sao Paulo,70,2,1,1,acept,3000,3000,39,6039
Campinas,308,3,3,4,acept,4700,673,71,5444
Rio de Janeiro,230,3,3,1,acept,10500,300,136,10936
Sao Paulo,51,2,1,1,acept,2500,23,32,2555
Sao Paulo,58,2,2,1,acept,2300,250,30,2580
Sao Paulo,76,2,1,1,not acept,4250,217,54,4521
Sao Paulo,236,4,5,4,acept,10000,1834,127,11961
Sao Paulo,86,2,2,2,acept,1950,267,25,2242
Sao Paulo,100,3,3,2,acept,4062,150,52,4264
Porto Alegre,54,2,1,0,acept,1100,42,17,1159
Sao Paulo,22,1,1,0,not acept,1956,50,25,2031
Sao Paulo,600,3,2,2,acept,7500,1000,113,8613
Rio de Janeiro,68,2,2,0,acept,1830,92,24,1946
Belo Horizonte,55,1,1,0,acept,895,0,15,910
Sao Paulo,36,1,1,0,acept,1600,60,21,1681
Sao Paulo,205,4,4,0,acept,9800,623,125,10548
Sao Paulo,60,2,1,1,acept,1980,0,26,2006
Sao Paulo,171,4,5,4,acept,8000,715,102,8817
Belo Horizonte,100,2,1,1,acept,1000,75,17,1092
Sao Paulo,71,2,2,1,acept,1830,153,24,2007
Sao Paulo,69,2,1,1,acept,1600,5,21,1626
Rio de Janeiro,15,1,1,0,acept,700,0,10,710
Sao Paulo,90,3,3,1,acept,4650,241,59,4950
Rio de Janeiro,80,2,2,0,acept,4100,165,53,4318
Rio de Janeiro,84,2,1,0,acept,1700,85,22,1807
Sao Paulo,834,5,5,7,not acept,10500,3417,158,14075
Sao Paulo,269,4,3,4,acept,5000,0,64,5064
Porto Alegre,43,1,1,1,acept,3300,100,49,3449
Sao Paulo,70,3,2,3,acept,2300,266,30,2596
Porto Alegre,336,2,2,2,acept,5556,591,82,6229
Campinas,76,3,2,1,acept,950,97,13,1060
Rio de Janeiro,280,3,3,1,acept,2190,14,29,2233
Sao Paulo,290,4,4,2,acept,7800,584,99,8483
Sao Paulo,200,4,3,3,acept,5000,1212,64,6276
Sao Paulo,130,2,2,0,acept,3974,71,51,4096
Sao Paulo,70,3,2,1,acept,3700,38,47,3785
Sao Paulo,22,1,1,0,not acept,6000,9,77,6086
Rio de Janeiro,80,3,2,2,acept,1358,213,18,1589
Sao Paulo,50,1,1,1,acept,1900,0,25,1925
Belo Horizonte,120,3,4,3,acept,6000,726,80,6806
Sao Paulo,120,2,1,2,acept,1470,12,19,1501
Rio de Janeiro,90,3,2,0,acept,1300,120,17,1437
Belo Horizonte,100,3,3,2,acept,1600,210,13,1823
Sao Paulo,98,4,4,2,acept,2485,0,32,2517
Porto Alegre,300,3,2,3,acept,2400,88,43,2531
Sao Paulo,107,4,3,2,acept,3560,225,46,3831
Sao Paulo,33,1,1,1,acept,3700,109,47,3856
Belo Horizonte,250,4,3,4,acept,10000,1228,134,11362
Belo Horizonte,65,2,2,0,not acept,800,50,11,861
Sao Paulo,150,3,3,2,acept,3700,567,47,4314
Belo Horizonte,97,2,1,0,not acept,1633,0,8,1641
Sao Paulo,410,5,7,3,acept,12000,750,181,12931
Sao Paulo,52,1,1,1,not acept,5000,284,64,5348
Rio de Janeiro,65,2,2,0,acept,1500,60,20,1580
Belo Horizonte,250,4,4,6,acept,8000,834,107,8941
Belo Horizonte,256,4,3,2,acept,11000,123,181,11304
Sao Paulo,53,2,2,1,not acept,1250,5,16,1271
Rio de Janeiro,30,1,1,0,not acept,900,100,12,1012
Rio de Janeiro,45,2,1,0,acept,700,15,10,725
Rio de Janeiro,44,2,1,0,acept,2650,82,35,2767
Belo Horizonte,506,4,5,0,acept,8000,452,132,8584
Rio de Janeiro,190,4,3,1,acept,3500,506,46,4052
Sao Paulo,48,1,1,0,not acept,2500,82,32,2614
Sao Paulo,162,3,3,1,acept,7000,492,89,7581
Sao Paulo,54,2,2,0,acept,5150,345,66,5561
Sao Paulo,320,4,3,8,acept,2150,450,33,2633
Sao Paulo,60,1,1,1,acept,5500,200,70,5770
Sao Paulo,194,3,4,4,acept,12000,1667,153,13820
Porto Alegre,54,1,1,1,not acept,1250,11,19,1280
Rio de Janeiro,90,2,2,0,acept,3500,255,46,3801
Sao Paulo,60,2,1,0,acept,1080,94,17,1191
Sao Paulo,40,1,1,1,not acept,1600,160,21,1781
Belo Horizonte,175,4,4,3,acept,4700,496,63,5259
Porto Alegre,233,4,6,4,acept,14000,584,249,14833
Sao Paulo,800,5,4,6,acept,12000,459,181,12640
Belo Horizonte,200,5,4,3,acept,5000,531,67,5598
Sao Paulo,120,4,4,2,acept,9500,116,121,9737
Belo Horizonte,23,1,1,0,not acept,900,25,12,937
Porto Alegre,27,1,1,0,acept,750,13,11,774
Sao Paulo,64,2,2,1,not acept,1900,152,29,2081
Belo Horizonte,180,4,1,3,acept,5900,180,97,6177
Sao Paulo,241,4,4,3,acept,5525,848,71,6444
Rio de Janeiro,80,2,2,1,acept,3060,181,40,3281
Campinas,20,1,1,0,not acept,930,9,12,951
Rio de Janeiro,140,3,3,0,acept,3800,359,49,4208
Rio de Janeiro,160,3,1,0,not acept,4100,474,53,4627
Sao Paulo,45,1,1,0,acept,2700,59,35,2794
Porto Alegre,79,2,1,0,acept,1105,84,17,1206
Rio de Janeiro,100,3,2,0,not acept,5000,234,65,5299
Sao Paulo,73,1,2,1,acept,3300,185,42,3527
Sao Paulo,36,1,1,2,not acept,3000,152,39,3191
Porto Alegre,30,1,1,0,acept,545,17,8,570
Rio de Janeiro,180,4,3,1,not acept,12850,1250,166,14266
Porto Alegre,42,1,1,0,acept,1200,33,18,1251
Porto Alegre,60,2,1,0,not acept,1500,34,27,1561
Sao Paulo,20,1,1,0,acept,1800,130,23,1953
Sao Paulo,42,1,1,1,acept,2200,100,28,2328
Belo Horizonte,140,4,3,3,acept,3200,545,43,3788
Sao Paulo,320,4,4,5,acept,15000,1750,226,16976
Belo Horizonte,120,3,2,1,acept,2100,149,28,2277
Sao Paulo,65,2,2,1,not acept,1850,0,28,1878
Sao Paulo,215,3,4,4,acept,10000,373,151,10524
Sao Paulo,52,2,1,0,acept,1000,30,13,1043
Sao Paulo,272,4,4,4,acept,13000,2250,165,15415
Sao Paulo,32,1,1,1,not acept,2200,142,28,2370
Sao Paulo,191,3,3,4,acept,15000,1299,191,16490
Sao Paulo,288,4,5,4,acept,4800,1167,61,6028
Campinas,37,1,1,1,not acept,825,33,11,869
Belo Horizonte,113,2,2,2,acept,2500,118,34,2652
Rio de Janeiro,50,1,1,0,acept,850,3,11,864
Sao Paulo,53,2,1,1,acept,2622,75,34,2731
Sao Paulo,76,2,2,2,acept,4500,0,58,4558
Sao Paulo,158,3,3,2,acept,10900,706,139,11745
Belo Horizonte,659,5,4,6,acept,11000,913,181,12094
Sao Paulo,180,3,3,1,not acept,3000,117,46,3163
Sao Paulo,42,1,1,1,acept,2900,35,37,2972
Campinas,89,2,1,1,acept,880,127,12,1019
Belo Horizonte,220,4,3,2,acept,3000,209,40,3249
Sao Paulo,90,2,2,0,acept,1700,38,26,1764
Rio de Janeiro,280,3,3,3,acept,4000,990,52,5042
Sao Paulo,40,1,1,0,acept,600,30,10,640
Sao Paulo,277,3,3,0,acept,8500,550,108,9158
Porto Alegre,70,3,2,1,acept,2300,111,34,2445
Campinas,200,2,1,1,acept,1410,250,22,1682
Campinas,74,3,2,2,acept,1600,0,21,1621
Sao Paulo,165,3,2,3,acept,3600,500,46,4146
Sao Paulo,60,2,2,1,acept,3400,300,44,3744
Rio de Janeiro,85,2,1,0,acept,7000,365,91,7456
Porto Alegre,56,2,1,0,acept,637,32,10,679
Rio de Janeiro,18,1,1,0,not acept,900,0,12,912
Sao Paulo,175,3,5,1,acept,5900,390,89,6379
Rio de Janeiro,60,2,2,1,not acept,1250,0,17,1267
Sao Paulo,220,4,2,3,acept,5200,705,79,5984
Sao Paulo,132,3,3,2,not acept,2700,606,35,3341
Sao Paulo,100,1,2,2,acept,7000,757,89,7846
Campinas,415,4,4,6,acept,9500,880,121,10501
Porto Alegre,300,3,5,3,acept,5500,360,98,5958
Sao Paulo,130,3,3,2,acept,6000,84,91,6175
Sao Paulo,300,4,4,1,acept,7200,700,92,7992
Campinas,165,3,2,1,acept,1800,294,23,2117
Campinas,32,1,1,0,not acept,600,4,8,612
Belo Horizonte,117,3,1,1,acept,1530,110,26,1666
Sao Paulo,890,5,6,8,not acept,11000,9500,166,20666
Porto Alegre,350,6,5,2,not acept,4000,334,72,4406
Sao Paulo,212,3,3,3,acept,9000,1084,115,10199
Sao Paulo,61,2,1,1,acept,1140,0,15,1155
Belo Horizonte,62,2,1,1,acept,950,0,13,963
Sao Paulo,884,5,7,6,acept,12750,5917,162,18829
Campinas,44,2,1,1,acept,1000,0,13,1013
Sao Paulo,157,3,2,0,acept,4500,302,58,4860
Sao Paulo,61,1,2,1,acept,5100,250,65,5415
Sao Paulo,50,1,1,0,acept,750,25,10,785
Sao Paulo,45,1,1,1,not acept,1500,80,23,1603
Campinas,36,1,1,0,acept,700,10,9,719
Campinas,48,2,1,1,acept,1190,0,16,1206
Sao Paulo,216,4,3,0,acept,8000,609,102,8711
Sao Paulo,485,4,7,7,acept,10900,1032,164,12096
Sao Paulo,110,2,2,2,acept,3800,480,49,4329
Sao Paulo,58,2,1,0,not acept,2400,10,31,2441
Rio de Janeiro,40,1,1,0,acept,1480,9,20,1509
Porto Alegre,30,1,1,1,acept,1110,0,17,1127
Belo Horizonte,44,1,1,1,acept,3400,222,46,3668
Sao Paulo,30,1,1,0,not acept,550,70,7,627
Sao Paulo,190,3,2,1,acept,6800,56,87,6943
Sao Paulo,32,1,1,1,acept,2744,0,35,2779
Porto Alegre,79,3,2,2,acept,2300,50,34,2384
Sao Paulo,90,3,3,2,not acept,3500,0,45,3545
Porto Alegre,61,2,1,0,acept,1200,22,18,1240
Sao Paulo,65,2,1,1,acept,1950,213,25,2188
Sao Paulo,76,2,2,0,acept,5500,299,70,5869
Rio de Janeiro,84,3,1,1,acept,1550,57,20,1627
Sao Paulo,60,2,1,1,acept,1790,70,23,1883
Sao Paulo,40,1,1,1,not acept,3990,90,51,4131
Sao Paulo,254,3,3,3,acept,12750,1692,162,14604
Sao Paulo,50,1,1,0,not acept,1250,34,19,1303
Belo Horizonte,400,4,4,4,acept,4900,320,81,5301
Sao Paulo,35,2,1,0,acept,1290,0,17,1307
Rio de Janeiro,76,3,2,1,acept,1800,65,24,1889
Sao Paulo,470,4,4,5,acept,6741,0,86,6827
Sao Paulo,40,2,1,1,acept,1300,30,17,1347
Belo Horizonte,200,3,1,2,acept,1630,117,27,1774
Rio de Janeiro,65,2,1,1,acept,1100,59,15,1174
Sao Paulo,97,2,2,0,not acept,10200,0,130,10330
Sao Paulo,113,3,2,2,acept,4800,250,61,5111
Sao Paulo,300,3,2,2,acept,3210,1417,49,4676
Sao Paulo,60,1,1,0,acept,4100,400,62,4562
Sao Paulo,20,1,1,0,acept,1800,130,23,1953
Sao Paulo,62,2,1,1,not acept,1345,35,18,1398
Sao Paulo,400,3,4,4,acept,15000,0,226,15226
Sao Paulo,100,3,3,2,acept,4100,100,62,4262
Sao Paulo,182,3,2,3,acept,12000,786,153,12939
Sao Paulo,50,2,1,2,not acept,2200,93,28,2321
Sao Paulo,50,2,2,1,not acept,3700,142,47,3889
Sao Paulo,84,1,2,1,acept,3353,0,25,3378
Sao Paulo,167,3,3,2,acept,3700,311,56,4067
Belo Horizonte,60,2,1,0,not acept,1150,50,19,1219
Campinas,220,3,1,4,not acept,2800,334,43,3177
Sao Paulo,67,2,1,0,acept,1050,31,14,1095
Rio de Janeiro,78,2,1,1,acept,1275,125,17,1417
Rio de Janeiro,63,2,2,0,acept,1200,51,16,1267
Rio de Janeiro,45,1,1,0,not acept,2000,96,26,2122
Campinas,151,3,2,3,acept,2500,251,32,2783
Belo Horizonte,90,2,2,0,acept,1250,55,17,1322
Belo Horizonte,54,2,1,1,acept,1280,57,18,1355
Sao Paulo,40,1,1,0,not acept,1094,0,17,1111
Rio de Janeiro,160,2,3,1,acept,1800,323,24,2147
Rio de Janeiro,230,3,3,2,acept,9000,1000,116,10116
Sao Paulo,22,1,1,0,acept,2200,55,28,2283
Sao Paulo,105,3,2,3,acept,2530,428,33,2991
Sao Paulo,63,2,1,2,acept,5500,220,70,5790
Sao Paulo,700,5,7,8,acept,6000,1800,91,7891
Campinas,80,2,1,1,acept,1000,0,13,1013
Sao Paulo,50,1,1,0,acept,1600,0,25,1625
Sao Paulo,234,4,3,3,acept,1920,423,25,2368
Sao Paulo,30,1,1,1,not acept,2900,180,37,3117
Sao Paulo,62,2,1,1,acept,1800,125,23,1948
Sao Paulo,350,3,3,3,acept,30000,560,451,31011
Sao Paulo,125,3,2,0,not acept,2700,495,35,3230
Porto Alegre,102,2,1,0,acept,1250,88,19,1357
Belo Horizonte,65,2,2,2,acept,1700,115,23,1838
Sao Paulo,130,3,2,1,not acept,2500,421,38,2959
Sao Paulo,151,3,2,1,acept,5000,474,64,5538
Belo Horizonte,82,3,2,2,acept,1200,69,16,1285
Sao Paulo,65,2,1,1,acept,2748,0,25,2773
Sao Paulo,189,3,4,3,acept,6000,67,77,6144
Sao Paulo,186,3,4,3,acept,8000,667,102,8769
Campinas,650,4,7,5,acept,8000,334,121,8455
Sao Paulo,65,2,2,1,acept,2800,222,36,3058
Sao Paulo,363,3,5,4,not acept,3072,1112,39,4223
Sao Paulo,71,3,2,2,acept,2500,50,32,2582
Rio de Janeiro,90,2,3,1,not acept,2960,265,39,3264
Belo Horizonte,266,4,3,4,acept,4500,362,74,4936
Sao Paulo,200,3,3,2,not acept,2800,186,43,3029
Porto Alegre,185,3,4,2,acept,2900,74,52,3026
Sao Paulo,138,3,3,2,acept,5800,475,74,6349
Rio de Janeiro,140,3,2,1,acept,3500,20,46,3566
Sao Paulo,90,1,2,1,acept,4200,58,54,4312
Sao Paulo,35,1,1,1,not acept,1249,0,8,1257
Belo Horizonte,25,2,1,0,not acept,2200,104,30,2334
Belo Horizonte,180,3,3,0,acept,3200,180,53,3433
Sao Paulo,200,3,3,2,acept,4000,770,51,4821
Sao Paulo,80,2,1,1,not acept,2900,84,37,3021
Porto Alegre,90,2,1,1,acept,1090,50,16,1156
Porto Alegre,170,3,3,2,acept,8000,209,143,8352
Campinas,380,3,3,5,acept,6500,413,98,7011
Campinas,76,2,1,0,acept,700,100,9,809
Sao Paulo,180,3,3,2,acept,11000,131,140,11271
Sao Paulo,20,1,1,0,acept,2060,0,27,2087
Sao Paulo,90,2,1,0,acept,1800,280,28,2108
Sao Paulo,64,2,1,1,acept,2000,108,26,2134
Sao Paulo,129,3,2,2,acept,2600,542,33,3175
Belo Horizonte,150,4,2,1,not acept,1800,218,24,2042
Porto Alegre,72,2,1,0,acept,1100,9,17,1126
Sao Paulo,220,3,4,4,acept,3375,1240,43,4658
Campinas,42,2,1,1,acept,846,0,11,857
Sao Paulo,79,1,2,2,not acept,5500,199,70,5769
Sao Paulo,110,3,1,0,acept,2000,0,31,2031
Sao Paulo,220,4,4,4,not acept,5500,834,70,6404
Sao Paulo,55,2,1,1,acept,1530,0,20,1550
Sao Paulo,64,2,2,2,acept,3400,47,44,3491
Sao Paulo,143,3,2,3,acept,4500,625,58,5183
Belo Horizonte,360,3,4,4,acept,2700,264,45,3009
Sao Paulo,500,2,2,1,acept,2140,0,33,2173
Rio de Janeiro,105,3,2,1,acept,3200,184,42,3426
Rio de Janeiro,137,3,3,1,acept,2900,214,38,3152
Sao Paulo,53,2,1,1,acept,4000,42,51,4093
Sao Paulo,58,1,1,1,acept,2800,334,36,3170
Sao Paulo,129,3,2,1,not acept,3100,167,40,3307
Sao Paulo,97,3,1,1,acept,6000,50,77,6127
Sao Paulo,89,2,3,3,acept,4300,244,55,4599
Campinas,480,3,6,4,acept,5400,584,82,6066
Campinas,45,1,1,0,not acept,500,24,7,531
Porto Alegre,44,1,1,0,acept,1300,40,19,1359
Sao Paulo,105,3,2,1,not acept,3600,60,46,3706
Sao Paulo,192,3,3,2,acept,2750,0,42,2792
Rio de Janeiro,450,4,4,2,acept,14000,1250,214,15464
Sao Paulo,38,1,1,0,acept,4500,6,58,4564
Campinas,63,1,1,0,acept,1280,24,17,1321
Sao Paulo,151,3,3,3,acept,4000,292,51,4343
Sao Paulo,55,2,1,1,acept,1381,305,21,1707
Sao Paulo,50,2,1,1,not acept,2650,25,34,2709
Campinas,202,3,2,2,acept,1890,267,29,2186
Rio de Janeiro,53,2,1,0,acept,1000,0,13,1013
Porto Alegre,80,3,3,0,acept,2200,0,33,2233
Sao Paulo,55,2,1,1,acept,1450,0,19,1469
Sao Paulo,120,4,2,3,acept,2960,459,38,3457
Sao Paulo,396,4,5,7,acept,5500,534,83,6117
Sao Paulo,44,1,1,0,acept,2300,0,30,2330
Porto Alegre,147,4,4,2,acept,1800,305,27,2132
Sao Paulo,290,5,3,3,acept,4100,1435,52,5587
Sao Paulo,270,1,1,0,acept,1400,0,22,1422
Sao Paulo,260,3,2,3,acept,8500,1084,108,9692
Sao Paulo,71,2,1,1,acept,2900,97,37,3034
Belo Horizonte,306,4,3,3,acept,7900,454,106,8460
Campinas,83,2,1,8,acept,4550,405,69,5024
Sao Paulo,89,3,2,1,acept,1760,100,23,1883
Sao Paulo,150,4,2,1,acept,3900,0,59,3959
Rio de Janeiro,70,2,1,0,not acept,2300,112,30,2442
Sao Paulo,212,4,3,2,acept,13800,694,175,14669
Sao Paulo,87,3,2,2,acept,2350,321,30,2701
Campinas,86,2,2,1,acept,1190,67,16,1273
Sao Paulo,250,4,2,6,acept,5000,458,76,5534
Rio de Janeiro,52,1,1,0,acept,3400,17,44,3461
Rio de Janeiro,439,13,4,3,acept,15000,667,229,15896
Belo Horizonte,70,3,1,1,acept,1210,50,17,1277
Sao Paulo,51,2,1,1,acept,2200,114,28,2342
Campinas,44,1,1,1,acept,850,27,11,888
Campinas,170,3,2,2,acept,1800,41,28,1869
Rio de Janeiro,60,2,2,1,acept,1050,57,14,1121
Sao Paulo,136,3,2,2,not acept,6818,332,87,7237
Sao Paulo,34,1,1,1,acept,1350,138,21,1509
Belo Horizonte,30,1,1,0,not acept,700,0,10,710
Rio de Janeiro,107,3,2,2,acept,5000,317,65,5382
Campinas,140,4,4,2,acept,3300,330,42,3672
Belo Horizonte,58,2,2,2,acept,1700,100,23,1823
Belo Horizonte,250,3,4,4,acept,8075,1333,108,9516
Sao Paulo,147,3,3,3,acept,12000,1000,153,13153
Belo Horizonte,180,3,2,2,acept,2300,231,31,2562
Sao Paulo,120,3,4,1,not acept,4000,4,61,4065
Sao Paulo,113,2,2,1,acept,3000,50,39,3089
Porto Alegre,27,1,1,0,acept,960,75,15,1050
Sao Paulo,202,4,4,2,acept,3000,250,39,3289
Belo Horizonte,95,3,2,2,acept,2600,155,35,2790
Sao Paulo,62,3,1,1,acept,1100,0,14,1114
Sao Paulo,188,3,4,3,acept,4800,750,61,5611
Campinas,38,1,1,0,not acept,892,17,12,921
Sao Paulo,45,1,1,0,not acept,950,17,15,982
Sao Paulo,150,4,3,2,acept,3800,220,49,4069
Sao Paulo,76,3,2,2,acept,4500,205,58,4763
Belo Horizonte,68,3,1,2,acept,850,0,12,862
Sao Paulo,166,3,2,2,acept,7000,882,89,7971
Porto Alegre,36,2,1,1,acept,1350,75,20,1445
Belo Horizonte,300,4,3,2,acept,5500,100,74,5674
Sao Paulo,350,4,4,4,acept,13000,1417,196,14613
Belo Horizonte,200,4,3,2,acept,4500,397,60,4957
Porto Alegre,140,3,1,0,acept,2000,150,30,2180
Sao Paulo,60,2,2,1,acept,2750,125,35,2910
Sao Paulo,194,4,6,4,not acept,8189,0,104,8293
Belo Horizonte,358,4,4,2,acept,4100,317,55,4472
Sao Paulo,199,2,3,3,not acept,12500,725,159,13384
Rio de Janeiro,130,3,2,1,acept,2750,265,36,3051
Sao Paulo,70,1,1,1,not acept,3110,200,40,3350
Sao Paulo,170,3,5,3,acept,3480,1085,45,4610
Rio de Janeiro,60,2,1,1,acept,810,80,11,901
Sao Paulo,48,1,1,1,not acept,4300,90,55,4445
Sao Paulo,70,2,1,0,acept,1550,0,24,1574
Sao Paulo,75,1,1,2,acept,2500,0,32,2532
Belo Horizonte,216,5,2,2,acept,4500,431,74,5005
Belo Horizonte,48,2,1,1,acept,1400,12,19,1431
Sao Paulo,167,3,3,3,acept,1670,555,22,2247
Sao Paulo,92,3,1,0,not acept,1700,13,22,1735
Sao Paulo,48,2,1,1,acept,1610,0,21,1631
Sao Paulo,300,6,6,4,acept,4700,584,71,5355
Campinas,245,4,3,2,acept,10500,167,134,10801
Sao Paulo,500,7,4,3,acept,14000,785,211,14996
Sao Paulo,138,2,3,2,acept,2180,606,28,2814
Sao Paulo,85,3,1,1,acept,1650,115,25,1790
Porto Alegre,104,3,2,1,acept,3400,125,50,3575
Sao Paulo,200,3,4,3,acept,7080,0,90,7170
Porto Alegre,50,1,1,1,acept,1190,0,18,1208
Belo Horizonte,88,3,1,1,acept,1359,0,7,1366
Rio de Janeiro,90,2,2,1,acept,2250,208,29,2487
Sao Paulo,225,2,2,3,acept,4800,450,73,5323
Porto Alegre,180,3,3,1,acept,2000,0,30,2030
Belo Horizonte,784,5,6,8,acept,12000,1641,197,13838
Sao Paulo,92,3,3,1,acept,4250,21,54,4325
Sao Paulo,170,3,3,3,acept,3000,1015,39,4054
Rio de Janeiro,400,3,4,2,acept,15000,1834,194,17028
Rio de Janeiro,40,1,1,0,acept,2950,97,39,3086
Sao Paulo,85,2,2,0,acept,2600,100,33,2733
Sao Paulo,40,1,1,1,not acept,1890,170,24,2084
Sao Paulo,280,4,6,3,acept,4800,1500,61,6361
Rio de Janeiro,98,3,2,0,acept,3390,239,44,3673
Sao Paulo,70,2,1,0,not acept,1300,0,20,1320
Sao Paulo,660,4,6,4,acept,6000,4283,91,10374
Belo Horizonte,449,5,7,4,acept,15000,308,246,15554
Sao Paulo,306,4,3,4,not acept,5330,2599,68,7997
Sao Paulo,150,3,2,2,acept,2500,0,38,2538
Sao Paulo,80,3,2,2,acept,2500,100,32,2632
Sao Paulo,22,1,1,0,acept,2100,40,27,2167
Porto Alegre,82,3,2,1,acept,1780,90,26,1896
Sao Paulo,119,3,3,1,not acept,3370,209,43,3622
Sao Paulo,113,1,1,2,acept,6400,0,82,6482
Porto Alegre,46,2,1,0,acept,807,30,12,849
Sao Paulo,138,3,1,0,acept,3500,445,53,3998
Sao Paulo,75,2,3,2,acept,2400,71,31,2502
Sao Paulo,98,3,2,1,acept,2400,0,31,2431
Rio de Janeiro,25,1,1,0,not acept,1336,63,18,1417
Belo Horizonte,202,3,2,2,not acept,3000,172,50,3222
Campinas,326,3,3,4,acept,4200,523,64,4787
Sao Paulo,49,2,1,1,not acept,1625,25,21,1671
Sao Paulo,52,1,1,1,acept,2500,38,32,2570
Belo Horizonte,258,4,4,3,acept,3500,338,47,3885
Sao Paulo,80,3,1,1,acept,2400,105,31,2536
Sao Paulo,100,3,3,0,acept,6330,148,81,6559
Porto Alegre,87,2,1,0,acept,2200,75,33,2308
Porto Alegre,42,2,1,0,acept,858,15,16,889
Rio de Janeiro,82,4,3,1,acept,4800,167,62,5029
Sao Paulo,200,2,1,1,acept,2450,200,37,2687
Sao Paulo,60,2,1,0,acept,3040,167,39,3246
Sao Paulo,250,3,4,4,not acept,10000,834,127,10961
Rio de Janeiro,60,1,1,1,acept,3900,167,51,4118
Sao Paulo,70,2,2,1,acept,2000,0,26,2026
Sao Paulo,79,2,2,1,acept,3594,267,46,3907
Sao Paulo,220,3,4,2,acept,4800,0,73,4873
Porto Alegre,38,1,1,0,not acept,1150,35,17,1202
Sao Paulo,310,5,4,5,acept,2700,2506,35,5241
Sao Paulo,87,2,2,2,acept,3300,209,42,3551
Sao Paulo,236,4,5,7,acept,10800,1084,137,12021
Sao Paulo,113,2,3,2,acept,13500,375,172,14047
Sao Paulo,45,2,1,0,not acept,1500,50,20,1570
Sao Paulo,144,4,2,0,not acept,3200,209,49,3458
Rio de Janeiro,24,1,1,0,acept,1412,25,19,1456
Porto Alegre,94,3,2,1,acept,3200,242,47,3489
Porto Alegre,27,1,1,0,not acept,1400,13,21,1434
Sao Paulo,210,3,4,3,acept,9945,1000,127,11072
Belo Horizonte,180,3,2,2,acept,2000,184,33,2217
Porto Alegre,25,1,1,0,acept,915,43,14,972
Belo Horizonte,100,3,1,2,acept,1400,77,19,1496
Sao Paulo,180,3,1,1,acept,9000,482,115,9597
Rio de Janeiro,46,2,1,0,acept,1400,0,19,1419
Sao Paulo,352,4,4,4,not acept,8600,479,130,9209
Sao Paulo,360,3,5,5,acept,9000,2120,115,11235
Sao Paulo,33,1,1,0,acept,1300,21,17,1338
Rio de Janeiro,125,4,2,2,not acept,4500,40,58,4598
Sao Paulo,360,4,5,5,acept,9600,584,145,10329
Sao Paulo,416,3,5,4,acept,10000,0,127,10127
Sao Paulo,400,3,4,5,acept,9500,1875,143,11518
Sao Paulo,43,2,1,1,acept,1900,0,25,1925
Rio de Janeiro,180,4,2,1,acept,6000,633,78,6711
Sao Paulo,100,3,1,0,acept,2630,334,34,2998
Sao Paulo,31,1,1,1,not acept,1990,125,26,2141
Rio de Janeiro,60,1,1,1,not acept,2400,123,10,2533
Sao Paulo,165,3,4,3,acept,3500,617,45,4162
Rio de Janeiro,250,5,2,5,acept,4675,270,72,5017
Sao Paulo,190,3,3,2,acept,4000,667,51,4718
Sao Paulo,276,3,3,0,not acept,12000,795,153,12948
Rio de Janeiro,140,3,2,2,acept,5500,546,71,6117
Porto Alegre,70,1,1,1,not acept,1050,34,16,1100
Sao Paulo,300,4,7,3,not acept,7000,121,106,7227
Sao Paulo,70,2,1,0,acept,2197,0,28,2225
Campinas,85,2,2,1,acept,1100,70,14,1184
Rio de Janeiro,75,2,1,0,not acept,2000,34,18,2052
Rio de Janeiro,120,3,1,0,not acept,3300,238,43,3581
Rio de Janeiro,92,2,2,0,acept,3000,195,39,3234
Rio de Janeiro,98,2,1,0,acept,2186,146,29,2361
Sao Paulo,118,3,2,2,acept,8950,402,114,9466
Rio de Janeiro,75,3,1,0,acept,1800,21,24,1845
Porto Alegre,75,2,2,1,acept,2000,91,30,2121
Sao Paulo,315,4,5,5,not acept,4000,1000,29,5029
Sao Paulo,55,2,1,1,acept,1000,0,13,1013
Sao Paulo,132,3,2,1,acept,2950,45,38,3033
Sao Paulo,100,2,1,1,acept,2700,98,41,2839
Sao Paulo,252,3,4,1,acept,12000,1233,181,13414
Sao Paulo,65,2,1,0,acept,1450,166,19,1635
Sao Paulo,20,1,1,0,acept,1800,130,23,1953
Campinas,150,3,4,2,acept,3400,0,44,3444
Sao Paulo,500,5,5,8,acept,9800,92,148,10040
Porto Alegre,27,1,1,0,not acept,1000,13,15,1028
Sao Paulo,500,3,4,7,not acept,9300,1060,140,10500
Sao Paulo,40,1,1,0,acept,1020,70,13,1103
Belo Horizonte,45,1,1,1,acept,2900,9,39,2948
Rio de Janeiro,86,2,2,2,acept,1500,116,20,1636
Sao Paulo,200,3,3,0,acept,5000,200,76,5276
Porto Alegre,49,1,1,0,acept,790,21,12,823
Sao Paulo,115,2,2,1,acept,4500,245,58,4803
Belo Horizonte,50,2,1,0,not acept,644,25,9,678
Sao Paulo,20,1,1,0,acept,1800,130,23,1953
Campinas,55,2,1,1,acept,900,25,12,937
Rio de Janeiro,78,2,1,1,acept,1050,84,14,1148
Sao Paulo,127,4,3,0,not acept,5300,407,68,5775
Sao Paulo,450,3,4,2,acept,15000,1450,191,16641
Sao Paulo,132,3,1,2,not acept,8000,400,102,8502
Sao Paulo,62,2,2,1,acept,3500,59,45,3604
Belo Horizonte,300,5,3,1,acept,3770,167,62,3999
Rio de Janeiro,195,4,1,0,acept,2990,156,46,3192
Campinas,45,2,1,0,not acept,1000,0,13,1013
Rio de Janeiro,52,1,1,0,not acept,1850,56,24,1930
Sao Paulo,46,2,1,1,acept,1100,72,14,1186
Belo Horizonte,179,3,3,0,acept,2400,203,32,2635
Rio de Janeiro,60,1,1,0,acept,3100,100,40,3240
Sao Paulo,45,1,1,0,acept,1000,0,13,1013
Belo Horizonte,200,4,3,2,acept,3400,713,56,4169
Rio de Janeiro,15,1,1,0,acept,700,0,10,710
Belo Horizonte,30,1,1,0,not acept,650,0,9,659
Belo Horizonte,100,3,3,1,not acept,1670,100,23,1793
Rio de Janeiro,120,3,3,0,acept,5500,167,71,5738
Sao Paulo,105,2,3,2,acept,3200,385,41,3626
Sao Paulo,97,2,3,2,acept,2660,167,34,2861
Rio de Janeiro,140,3,2,1,acept,4200,250,55,4505
Sao Paulo,90,3,3,2,acept,2630,417,34,3081
Sao Paulo,50,1,1,0,acept,2200,0,28,2228
Belo Horizonte,330,5,4,2,acept,8000,267,132,8399
Sao Paulo,367,3,5,3,acept,6000,1500,77,7577
Sao Paulo,75,3,2,1,acept,3900,0,50,3950
Porto Alegre,63,2,1,0,acept,1400,53,21,1474
Campinas,72,2,1,2,acept,1200,89,16,1305
Campinas,52,2,1,1,acept,1800,70,23,1893
Sao Paulo,57,2,2,1,not acept,2600,0,33,2633
Sao Paulo,200,3,3,1,not acept,3800,834,49,4683
Rio de Janeiro,64,3,2,0,acept,1300,251,17,1568
Sao Paulo,211,3,2,2,acept,11000,483,140,11623
Campinas,164,3,2,2,acept,2100,293,32,2425
Sao Paulo,240,3,3,2,acept,4500,250,68,4818
Campinas,64,2,1,1,acept,820,122,11,953
Sao Paulo,89,2,3,1,acept,5700,204,73,5977
Campinas,120,3,3,2,not acept,1850,0,24,1874
Sao Paulo,69,2,2,1,not acept,4100,234,52,4386
Sao Paulo,140,3,4,2,acept,2500,517,32,3049
Sao Paulo,103,2,1,0,acept,1300,80,20,1400
Sao Paulo,82,2,2,0,not acept,2800,135,36,2971
Sao Paulo,30,1,1,0,acept,1585,30,21,1636
Campinas,60,2,1,1,not acept,1400,60,18,1478
Sao Paulo,162,3,2,2,acept,8000,42,102,8144
Sao Paulo,59,2,1,1,acept,3000,0,39,3039
Sao Paulo,230,3,3,3,not acept,10500,792,134,11426
Sao Paulo,110,3,2,1,not acept,4500,0,58,4558
Campinas,210,3,3,3,acept,2300,459,30,2789
Sao Paulo,218,3,2,2,not acept,7800,550,99,8449
Campinas,50,1,1,1,not acept,1600,13,21,1634
Belo Horizonte,115,3,3,2,acept,1920,209,26,2155
Sao Paulo,100,2,2,0,acept,2000,63,26,2089
Sao Paulo,230,3,4,4,acept,5000,0,64,5064
Rio de Janeiro,25,1,1,0,acept,700,0,10,710
Sao Paulo,280,3,4,2,not acept,15000,684,226,15910
Sao Paulo,390,3,4,4,not acept,9000,2682,115,11797
Sao Paulo,60,2,2,2,acept,2872,238,37,3147
Sao Paulo,150,3,2,2,acept,5000,484,64,5548
Rio de Janeiro,60,2,1,1,not acept,1000,500,13,1513
Sao Paulo,22,1,1,0,not acept,1080,14,14,1108
Rio de Janeiro,30,1,1,1,acept,850,70,11,931
Sao Paulo,49,2,2,1,acept,1550,100,20,1670
Sao Paulo,230,3,4,3,acept,4700,834,60,5594
Rio de Janeiro,200,3,4,2,acept,8000,600,104,8704
Belo Horizonte,167,4,4,3,acept,4600,642,62,5304
Belo Horizonte,420,4,6,5,not acept,15000,167,200,15367
Porto Alegre,98,2,1,0,acept,1800,92,27,1919
Belo Horizonte,80,3,1,1,acept,1300,69,18,1387
Campinas,30,1,1,0,acept,500,10,7,517
Sao Paulo,296,4,5,5,acept,12900,2105,164,15169
Rio de Janeiro,70,2,1,0,not acept,1100,42,15,1157
Rio de Janeiro,160,2,2,2,acept,7500,250,97,7847
Sao Paulo,73,2,2,1,acept,1250,150,16,1416
Rio de Janeiro,15,1,1,0,acept,700,0,10,710
Sao Paulo,174,3,1,1,acept,3300,236,50,3586
Porto Alegre,54,1,1,1,acept,1200,42,18,1260
Sao Paulo,50,1,1,1,not acept,8800,250,112,9162
Sao Paulo,240,3,3,3,acept,10500,417,134,11051
Belo Horizonte,260,4,4,2,acept,15000,203,246,15449
Sao Paulo,210,3,4,4,not acept,6375,625,81,7081
Sao Paulo,119,3,4,3,acept,3680,30,47,3757
Belo Horizonte,150,3,1,3,acept,3500,750,58,4308
Sao Paulo,750,4,7,8,acept,15000,1667,226,16893
Sao Paulo,67,2,1,1,not acept,1800,40,23,1863
Rio de Janeiro,50,1,1,0,acept,1428,81,6,1515
Rio de Janeiro,36,1,1,0,acept,2500,55,33,2588
Sao Paulo,120,3,2,2,acept,1900,377,25,2302
Porto Alegre,65,3,1,1,acept,850,31,13,894
Belo Horizonte,240,4,4,2,acept,8000,150,107,8257
Sao Paulo,93,2,2,2,acept,3500,200,45,3745
Porto Alegre,35,1,1,0,acept,1170,92,18,1280
Sao Paulo,51,2,1,1,not acept,2200,109,28,2337
Sao Paulo,85,2,2,1,acept,3300,94,42,3436
Campinas,57,1,2,1,acept,2961,111,38,3110
Campinas,50,1,1,0,acept,550,0,3,553
Sao Paulo,75,2,1,0,acept,1500,325,23,1848
Sao Paulo,161,3,3,3,acept,10000,667,127,10794
Campinas,210,4,4,3,not acept,3600,495,46,4141
Sao Paulo,350,3,2,4,acept,12500,1334,188,14022
Porto Alegre,112,3,3,2,acept,3000,234,44,3278
Campinas,78,3,2,2,acept,1900,37,25,1962
Sao Paulo,54,2,2,1,acept,2800,199,36,3035
Campinas,25,1,1,0,not acept,1020,0,4,1024
Sao Paulo,62,2,2,0,not acept,2000,0,26,2026
Sao Paulo,117,2,2,1,not acept,7130,150,91,7371
Sao Paulo,120,4,2,2,acept,3500,10,53,3563
Campinas,113,3,2,2,acept,1450,79,19,1548
Sao Paulo,65,2,1,1,acept,2306,0,30,2336
Campinas,70,2,1,1,not acept,1100,60,14,1174
Porto Alegre,67,3,2,2,acept,2000,50,30,2080
Sao Paulo,651,7,7,8,acept,8500,1595,128,10223
Sao Paulo,180,3,1,5,acept,6500,567,98,7165
Sao Paulo,30,1,1,0,acept,1000,21,13,1034
Sao Paulo,100,3,3,3,acept,3500,417,45,3962
Sao Paulo,45,1,1,0,acept,1450,55,19,1524
Sao Paulo,400,4,4,4,acept,8500,1250,128,9878
Sao Paulo,100,3,1,0,acept,2200,139,28,2367
Porto Alegre,111,2,2,0,acept,1612,100,24,1736
Belo Horizonte,70,2,2,2,acept,2100,240,28,2368
Porto Alegre,179,3,2,2,acept,3700,67,66,3833
Rio de Janeiro,140,3,2,2,acept,5700,579,74,6353
Sao Paulo,260,3,4,2,acept,7609,876,115,8600
Belo Horizonte,268,4,2,4,not acept,3000,381,40,3421
Belo Horizonte,70,3,2,1,acept,1300,59,18,1377
Rio de Janeiro,50,1,1,1,acept,1500,323,20,1843
Belo Horizonte,470,5,4,2,acept,6000,808,99,6907
Sao Paulo,142,3,4,3,acept,4600,3509,33,8142
Sao Paulo,80,1,2,2,acept,6522,0,83,6605
Sao Paulo,100,3,3,3,not acept,2500,246,38,2784
Porto Alegre,47,1,1,1,not acept,2200,0,33,2233
Campinas,180,3,4,4,acept,3230,250,49,3529
Porto Alegre,180,4,1,1,acept,4480,375,80,4935
Sao Paulo,72,1,1,1,not acept,4000,175,51,4226
Sao Paulo,90,2,2,1,acept,2200,0,34,2234
Campinas,49,1,1,0,acept,583,23,8,614
Porto Alegre,282,4,2,4,acept,5000,355,89,5444
Sao Paulo,114,4,4,2,acept,2530,321,33,2884
Sao Paulo,170,3,3,2,acept,7000,559,89,7648
Sao Paulo,200,3,2,3,acept,3600,251,55,3906
Sao Paulo,130,4,4,3,acept,3000,459,39,3498
Belo Horizonte,300,3,4,4,acept,7500,350,123,7973
Sao Paulo,40,1,2,1,not acept,4200,318,54,4572
Sao Paulo,45,1,1,0,not acept,750,0,10,760
Sao Paulo,245,3,5,4,acept,10000,1218,127,11345
Sao Paulo,155,2,3,2,acept,4000,377,61,4438
Belo Horizonte,300,3,3,4,acept,3500,431,58,3989
Campinas,438,5,4,0,acept,7735,417,117,8269
Rio de Janeiro,30,1,1,0,not acept,2200,59,29,2288
Sao Paulo,125,2,2,1,acept,2800,392,43,3235
Campinas,76,1,2,0,acept,700,100,9,809
Sao Paulo,58,2,2,2,acept,2030,189,26,2245
Sao Paulo,140,3,2,2,acept,2600,45,40,2685
Sao Paulo,49,2,1,1,acept,1368,0,18,1386
Porto Alegre,45,1,1,0,acept,900,658,14,1572
Sao Paulo,350,4,6,4,acept,10000,896,151,11047
Sao Paulo,35,1,1,0,acept,1700,0,22,1722
Rio de Janeiro,100,3,1,1,acept,1700,17,22,1739
Porto Alegre,86,2,2,2,acept,2950,120,44,3114
Campinas,58,1,1,1,acept,3300,108,42,3450
Sao Paulo,40,1,1,0,not acept,780,17,12,809
Porto Alegre,62,3,2,1,acept,2100,50,31,2181
Belo Horizonte,95,3,2,2,acept,2300,143,31,2474
Sao Paulo,52,1,1,1,acept,2100,38,27,2165
Sao Paulo,80,2,1,0,acept,1280,59,20,1359
Belo Horizonte,300,4,4,4,acept,6500,428,107,7035
Sao Paulo,70,2,2,0,acept,1390,212,18,1620
Porto Alegre,130,3,3,1,acept,4900,167,72,5139
Campinas,39,1,1,1,not acept,1128,32,15,1175
Belo Horizonte,73,2,1,1,acept,4500,40,60,4600
Sao Paulo,68,2,1,1,acept,2280,9,29,2318
Campinas,80,2,1,0,acept,1200,0,19,1219
Sao Paulo,30,1,1,1,acept,1560,61,20,1641
Rio de Janeiro,450,4,5,1,acept,3300,417,51,3768
Sao Paulo,270,3,4,2,acept,15000,1100,191,16291
Sao Paulo,146,3,4,4,acept,6000,631,77,6708
Rio de Janeiro,100,3,1,0,acept,2000,209,26,2235
Campinas,60,2,1,1,acept,1000,0,13,1013
Sao Paulo,55,2,1,1,not acept,3500,135,45,3680
Rio de Janeiro,140,4,2,1,not acept,6000,380,78,6458
Campinas,40,1,1,1,acept,650,35,9,694
Belo Horizonte,20,1,1,1,acept,1100,0,15,1115
Porto Alegre,30,1,1,0,not acept,500,0,9,509
Sao Paulo,68,2,2,2,not acept,2300,0,30,2330
Campinas,35,1,1,1,acept,966,25,13,1004
Sao Paulo,190,4,4,3,acept,6900,0,88,6988
Sao Paulo,700,4,10,0,acept,15000,8750,226,23976
Rio de Janeiro,45,1,1,0,acept,1200,78,16,1294
Sao Paulo,311,3,6,4,not acept,12500,1084,159,13743
Porto Alegre,110,2,1,0,acept,1070,1160,20,2250
Campinas,330,3,3,2,not acept,5100,650,65,5815
Sao Paulo,75,3,1,1,acept,1900,85,25,2010
Porto Alegre,50,1,1,0,acept,1600,42,24,1666
Sao Paulo,460,4,4,6,acept,5280,667,80,6027
Porto Alegre,52,2,1,0,acept,730,21,11,762
Sao Paulo,155,3,4,2,acept,13100,409,166,13675
Belo Horizonte,55,2,1,1,acept,840,77,12,929
Rio de Janeiro,74,2,1,0,acept,1900,189,25,2114
Sao Paulo,26,1,1,1,acept,1396,0,18,1414
Sao Paulo,80,2,1,0,acept,3000,0,39,3039
Sao Paulo,450,4,5,5,not acept,12000,1875,181,14056
Campinas,150,2,2,1,acept,1060,167,16,1243
Sao Paulo,135,3,2,2,acept,4200,543,54,4797
Belo Horizonte,140,4,3,4,acept,3500,230,47,3777
Campinas,76,3,1,1,acept,1300,92,17,1409
Sao Paulo,450,4,3,6,acept,11900,1084,179,13163
Belo Horizonte,38,1,1,0,not acept,1300,0,18,1318
Sao Paulo,56,2,2,1,acept,2000,0,26,2026
Rio de Janeiro,30,1,1,0,not acept,1512,0,7,1519
Sao Paulo,260,2,2,2,not acept,3800,567,58,4425
Porto Alegre,77,3,2,1,not acept,1260,20,19,1299
Rio de Janeiro,290,4,3,1,acept,7000,459,91,7550
Belo Horizonte,22,1,1,1,not acept,1500,0,20,1520
Rio de Janeiro,47,2,1,0,acept,1500,0,20,1520
Sao Paulo,80,2,2,1,acept,3700,96,47,3843
Sao Paulo,244,4,3,4,acept,4774,1033,61,5868
Campinas,45,1,1,0,acept,800,39,11,850
Belo Horizonte,85,3,2,2,not acept,1700,160,23,1883
Sao Paulo,98,3,2,2,acept,2000,383,26,2409
Sao Paulo,100,2,1,1,not acept,1450,0,22,1472
Rio de Janeiro,120,3,2,0,acept,3700,331,48,4079
Sao Paulo,190,3,2,1,acept,4500,150,58,4708
Sao Paulo,500,4,4,4,acept,10200,1800,154,12154
Sao Paulo,105,3,2,2,acept,7800,488,99,8387
Campinas,50,2,1,1,acept,1000,20,13,1033
Sao Paulo,126,4,3,2,not acept,4500,417,58,4975
Sao Paulo,74,2,3,1,acept,4500,105,58,4663
Rio de Janeiro,130,3,3,2,acept,7000,500,91,7591
Sao Paulo,140,2,1,1,not acept,5500,300,70,5870
Porto Alegre,160,3,2,2,acept,2000,75,36,2111
Sao Paulo,250,3,4,3,acept,14000,1256,178,15434
Rio de Janeiro,90,2,2,1,acept,900,144,12,1056
Sao Paulo,35,1,1,0,acept,1660,0,22,1682
Rio de Janeiro,144,4,2,2,acept,3590,378,47,4015
Rio de Janeiro,170,3,1,1,acept,2480,100,32,2612
Rio de Janeiro,65,2,1,1,acept,1400,59,19,1478
Porto Alegre,80,2,1,0,acept,990,0,18,1008
Sao Paulo,20,1,1,0,not acept,3142,67,40,3249
Sao Paulo,79,2,2,2,not acept,5900,280,75,6255
Sao Paulo,70,2,1,0,acept,2448,159,32,2639
Sao Paulo,30,1,1,0,not acept,2350,46,30,2426
Sao Paulo,250,3,5,3,acept,6800,0,87,6887
Porto Alegre,50,1,1,0,acept,930,25,14,969
Sao Paulo,116,3,2,2,acept,2300,568,30,2898
Sao Paulo,216,4,3,4,not acept,5000,657,64,5721
Sao Paulo,290,3,5,4,acept,7000,0,89,7089
Sao Paulo,300,5,6,6,acept,9500,2084,143,11727
Sao Paulo,245,4,3,4,acept,6000,1667,77,7744
Belo Horizonte,150,4,2,3,not acept,4900,480,66,5446
Sao Paulo,130,3,4,2,not acept,2318,411,30,2759
Sao Paulo,112,1,2,3,acept,2878,84,44,3006
Sao Paulo,78,2,2,1,acept,1680,63,22,1765
Rio de Janeiro,15,1,1,0,acept,700,0,10,710
Sao Paulo,84,2,1,2,not acept,4000,240,51,4291
Rio de Janeiro,23,1,1,0,not acept,2000,25,26,2051
Belo Horizonte,174,3,1,0,not acept,5500,120,91,5711
Sao Paulo,104,1,3,2,not acept,4200,500,54,4754
Porto Alegre,63,1,1,0,acept,900,38,14,952
Sao Paulo,51,2,1,1,acept,1100,75,14,1189
Rio de Janeiro,70,2,2,1,acept,3460,332,45,3837
Belo Horizonte,150,4,4,2,acept,4000,501,54,4555
Rio de Janeiro,90,2,2,1,acept,2156,90,9,2255
Rio de Janeiro,80,2,2,1,acept,7500,584,97,8181
Porto Alegre,60,1,1,1,not acept,800,209,12,1021
Belo Horizonte,85,3,2,1,not acept,1500,85,20,1605
Sao Paulo,70,2,1,0,not acept,3200,50,41,3291
Rio de Janeiro,50,1,1,0,not acept,800,26,11,837
Sao Paulo,38,1,1,0,acept,2080,24,27,2131
Porto Alegre,147,3,3,3,acept,2600,81,47,2728
Porto Alegre,222,3,2,2,not acept,5083,350,75,5508
Sao Paulo,185,4,4,4,acept,7500,1042,96,8638
Campinas,284,3,5,6,acept,5100,417,77,5594
Sao Paulo,45,2,1,1,not acept,1470,30,19,1519
Rio de Janeiro,290,3,3,1,acept,5300,853,69,6222
Sao Paulo,74,3,2,2,acept,1250,100,16,1366
Campinas,115,3,2,2,acept,2690,214,35,2939
Porto Alegre,37,1,1,0,acept,1600,67,24,1691
Belo Horizonte,650,7,6,3,acept,13000,1250,214,14464
Sao Paulo,30,1,1,0,not acept,1459,0,10,1469
Sao Paulo,87,1,1,2,acept,7900,150,101,8151
Sao Paulo,553,5,6,5,acept,3360,2827,43,6230
Sao Paulo,250,3,4,4,acept,10700,1224,136,12060
Sao Paulo,600,4,5,6,acept,6000,3000,51,9051
Sao Paulo,250,3,3,3,acept,4500,150,68,4718
Sao Paulo,30,1,1,1,acept,1799,0,23,1822
Belo Horizonte,62,3,1,1,not acept,950,59,13,1022
Rio de Janeiro,115,2,2,2,acept,3000,75,39,3114
Rio de Janeiro,130,3,1,0,acept,6800,193,28,7021
Sao Paulo,35,1,1,0,acept,2000,0,26,2026
Belo Horizonte,350,4,3,3,not acept,10000,658,134,10792
Sao Paulo,100,3,2,0,not acept,3000,914,46,3960
Campinas,85,3,2,2,acept,2600,182,33,2815
Sao Paulo,60,1,1,1,acept,1500,100,23,1623
Campinas,197,3,3,2,acept,2500,325,32,2857
Sao Paulo,177,4,5,4,acept,9200,959,117,10276
Rio de Janeiro,96,2,1,0,acept,5000,181,65,5246
Sao Paulo,48,1,1,0,not acept,1150,34,18,1202
Sao Paulo,678,5,6,4,acept,15000,3000,226,18226
Rio de Janeiro,126,2,2,1,acept,7500,420,97,8017
Sao Paulo,130,3,3,1,acept,4200,257,54,4511
Campinas,113,2,1,1,acept,1250,92,16,1358
Sao Paulo,380,3,4,2,acept,12000,959,181,13140
Sao Paulo,80,1,1,1,acept,2500,180,32,2712
Sao Paulo,20,1,1,0,acept,1800,130,23,1953
Sao Paulo,32,1,1,1,acept,1880,0,24,1904
Sao Paulo,420,4,6,4,acept,15000,2250,191,17441
Sao Paulo,500,8,5,2,acept,11000,1550,166,12716
Sao Paulo,33,1,1,1,acept,2900,84,37,3021
Sao Paulo,700,4,6,6,acept,12500,2176,188,14864
Sao Paulo,50,1,1,1,acept,1100,0,17,1117
Porto Alegre,70,2,2,0,acept,1410,59,21,1490
Belo Horizonte,332,3,2,8,not acept,7000,270,115,7385
Rio de Janeiro,83,2,3,2,acept,6000,1128,78,7206
Campinas,62,2,2,2,acept,3000,14,39,3053
Sao Paulo,30,1,1,0,acept,3300,0,42,3342
Sao Paulo,240,4,6,4,not acept,4410,0,56,4466
Sao Paulo,27,1,1,0,not acept,835,0,13,848
Rio de Janeiro,87,3,2,1,acept,1440,67,19,1526
Porto Alegre,238,3,3,3,acept,4180,167,62,4409
Rio de Janeiro,68,2,1,0,acept,2300,245,30,2575
Rio de Janeiro,30,1,1,0,acept,800,126,11,937
Rio de Janeiro,24,1,1,0,acept,1200,25,16,1241
Sao Paulo,80,3,2,1,not acept,1613,80,21,1714
Belo Horizonte,70,3,1,1,acept,1100,63,15,1178
Sao Paulo,250,4,3,2,not acept,10000,0,151,10151
Belo Horizonte,83,3,3,2,acept,3500,216,47,3763
Porto Alegre,339,3,5,4,acept,14000,834,205,15039
Campinas,75,2,1,1,acept,1300,0,17,1317
Sao Paulo,154,4,3,3,acept,4350,742,56,5148
Rio de Janeiro,80,2,2,1,acept,1800,125,24,1949
Porto Alegre,156,3,1,0,acept,1600,142,24,1766
Sao Paulo,190,3,4,3,acept,5950,1209,76,7235
Sao Paulo,200,3,2,2,acept,2900,791,44,3735
Belo Horizonte,600,3,5,8,acept,10000,202,164,10366
Belo Horizonte,57,3,2,1,acept,1100,78,15,1193
Belo Horizonte,110,3,2,2,not acept,2600,248,20,2868
Sao Paulo,240,3,4,5,acept,6400,1400,82,7882
Sao Paulo,40,1,1,1,not acept,2800,100,36,2936
Campinas,160,3,2,2,acept,1650,243,21,1914
Sao Paulo,120,3,2,2,acept,3940,875,50,4865
Campinas,51,1,1,1,acept,820,90,11,921
Porto Alegre,55,1,1,1,acept,2300,45,34,2379
Sao Paulo,820,4,4,5,acept,7225,3750,109,11084
Sao Paulo,168,3,4,2,acept,5500,65,70,5635
Porto Alegre,68,1,2,1,acept,2500,117,37,2654
Sao Paulo,260,4,4,6,acept,5500,1167,70,6737
Sao Paulo,93,2,2,1,acept,2490,12,32,2534
Sao Paulo,73,2,2,1,acept,1250,150,16,1416
Sao Paulo,182,3,3,5,acept,4200,250,64,4514
Rio de Janeiro,215,3,2,0,acept,4000,38,52,4090
Sao Paulo,280,3,3,4,acept,9500,990,143,10633
Rio de Janeiro,68,2,1,1,acept,870,109,12,991
Sao Paulo,76,1,2,1,acept,4200,30,54,4284
Sao Paulo,156,3,4,3,acept,9000,667,115,9782
Porto Alegre,271,4,3,1,acept,3900,500,57,4457
Campinas,297,4,6,2,acept,2800,433,36,3269
Sao Paulo,73,2,1,1,acept,1360,6,18,1384
Sao Paulo,350,3,4,5,acept,5500,1092,83,6675
Sao Paulo,100,2,3,3,acept,7650,250,97,7997
Sao Paulo,100,3,2,0,not acept,2000,250,26,2276
Campinas,180,3,4,4,acept,4500,127,68,4695
Sao Paulo,350,7,4,2,acept,4600,292,70,4962
Porto Alegre,40,1,1,0,acept,1000,6,15,1021
Rio de Janeiro,106,3,2,1,acept,5000,338,65,5403
Sao Paulo,63,2,2,1,acept,11000,133,140,11273
Rio de Janeiro,200,4,3,2,acept,9200,603,119,9922
Rio de Janeiro,65,2,2,0,acept,3600,103,47,3750
Rio de Janeiro,25,1,1,0,acept,1984,55,23,2062
Sao Paulo,95,3,2,2,acept,1200,296,16,1512
Sao Paulo,36,1,1,1,acept,3400,80,44,3524
Rio de Janeiro,273,4,4,2,acept,10200,632,132,10964
Sao Paulo,159,2,2,1,acept,4200,251,54,4505
Rio de Janeiro,110,2,2,1,acept,5000,1417,65,6482
Porto Alegre,130,4,4,3,acept,10840,292,159,11291
Sao Paulo,20,1,1,0,not acept,990,0,13,1003
Sao Paulo,330,4,5,4,acept,4000,274,61,4335
Rio de Janeiro,30,1,1,0,not acept,1216,25,16,1257
Sao Paulo,190,4,3,2,acept,5000,570,64,5634
Sao Paulo,195,2,3,1,acept,6000,334,77,6411
Sao Paulo,43,2,7,2,acept,2270,0,29,2299
Campinas,49,2,1,1,acept,950,0,13,963
Sao Paulo,68,3,1,1,acept,1410,115,18,1543
Porto Alegre,63,2,2,2,acept,2150,70,32,2252
Sao Paulo,298,4,4,3,acept,9000,1190,115,10305
Sao Paulo,52,1,2,1,acept,3850,297,49,4196
Sao Paulo,350,3,2,4,acept,10200,992,154,11346
Sao Paulo,170,4,2,1,acept,5200,570,66,5836
Rio de Janeiro,120,3,2,2,acept,5300,350,69,5719
Rio de Janeiro,30,1,1,0,acept,1250,0,17,1267
Belo Horizonte,67,2,1,0,not acept,1140,71,16,1227
Sao Paulo,210,3,4,0,acept,4200,175,64,4439
Porto Alegre,40,1,1,1,not acept,1050,8,16,1074
Porto Alegre,117,3,2,1,acept,3400,217,50,3667
Sao Paulo,67,2,1,1,acept,1420,4,18,1442
Belo Horizonte,70,3,2,2,acept,1900,228,26,2154
Porto Alegre,60,2,1,2,acept,1400,0,25,1425
Sao Paulo,856,5,7,6,acept,10000,5000,127,15127
Rio de Janeiro,34,1,1,0,acept,1700,65,22,1787
Sao Paulo,717,5,5,8,acept,2500,5032,32,7564
Porto Alegre,96,2,1,0,not acept,1000,40,15,1055
Sao Paulo,20,1,1,0,acept,1800,130,23,1953
Porto Alegre,70,1,2,0,not acept,1500,59,27,1586
Rio de Janeiro,65,1,1,0,not acept,2400,116,31,2547
Sao Paulo,58,2,2,1,acept,1783,0,23,1806
Sao Paulo,140,3,3,3,acept,4200,775,54,5029
Sao Paulo,195,3,4,3,acept,8500,59,128,8687
Rio de Janeiro,83,2,1,1,acept,1800,104,24,1928
Porto Alegre,40,1,1,1,acept,1250,6,19,1275
Sao Paulo,70,1,1,0,not acept,900,0,14,914
Rio de Janeiro,94,3,3,2,acept,5000,357,65,5422
Sao Paulo,34,1,1,1,not acept,2800,0,36,2836
Campinas,30,1,1,0,acept,503,10,7,520
Sao Paulo,73,2,2,1,acept,1250,150,16,1416
Campinas,270,3,3,3,acept,7220,560,92,7872
Sao Paulo,40,1,1,1,not acept,3000,183,39,3222
Sao Paulo,25,1,1,0,not acept,836,0,13,849
Sao Paulo,112,3,2,1,acept,3850,98,49,3997
Sao Paulo,105,3,2,2,acept,2583,35,33,2651
Sao Paulo,130,3,2,2,acept,3300,108,50,3458
Belo Horizonte,118,4,2,1,acept,2300,111,31,2442
Campinas,85,3,2,1,acept,1300,75,17,1392
Sao Paulo,380,4,4,3,acept,7500,0,113,7613
Belo Horizonte,55,2,1,1,acept,1200,83,16,1299
Sao Paulo,109,3,2,1,acept,5300,0,68,5368
Belo Horizonte,758,5,4,5,acept,15000,2752,200,17952
Belo Horizonte,300,4,3,3,acept,6290,519,104,6913
Belo Horizonte,72,2,3,0,acept,2400,220,32,2652
Belo Horizonte,148,4,3,2,acept,5500,399,74,5973
Porto Alegre,75,2,1,0,acept,1000,34,15,1049
Rio de Janeiro,68,2,2,1,not acept,1100,42,15,1157
Sao Paulo,64,2,2,2,not acept,2100,59,27,2186
Belo Horizonte,206,4,3,2,acept,6500,565,87,7152
Sao Paulo,320,3,4,3,acept,6800,1,87,6888
Rio de Janeiro,116,3,3,2,not acept,2500,230,33,2763
Campinas,560,7,7,8,acept,9000,911,136,10047
Sao Paulo,320,4,3,4,acept,5200,292,66,5558
Rio de Janeiro,55,1,1,1,acept,2400,635,31,3066
Sao Paulo,85,2,2,0,acept,4900,0,63,4963
Sao Paulo,100,2,2,1,not acept,2690,8,35,2733
Sao Paulo,400,5,5,5,acept,6400,2500,97,8997
Porto Alegre,220,3,2,2,acept,2600,53,47,2700
Rio de Janeiro,80,2,2,0,acept,2000,289,26,2315
Campinas,66,1,1,2,acept,1600,41,21,1662
Porto Alegre,80,2,2,1,acept,2000,0,30,2030
Sao Paulo,260,5,4,4,acept,11000,1400,140,12540
Sao Paulo,450,4,5,6,not acept,9000,1150,136,10286
Porto Alegre,88,2,2,1,acept,2100,800,31,2931
Campinas,157,3,5,3,acept,7000,442,89,7531
Sao Paulo,129,3,5,0,acept,6000,561,77,6638
Sao Paulo,23,1,1,1,acept,2300,59,30,2389
Sao Paulo,692,5,6,5,acept,15000,1667,226,16893
Sao Paulo,310,3,4,3,acept,4500,900,58,5458
Porto Alegre,215,3,4,2,acept,3600,300,53,3953
Sao Paulo,250,3,4,2,acept,4200,192,64,4456
Sao Paulo,140,3,2,2,not acept,2000,171,26,2197
Sao Paulo,100,1,1,0,not acept,950,0,15,965
Campinas,47,2,1,1,acept,1200,20,16,1236
Campinas,48,2,1,1,acept,1200,40,16,1256
Sao Paulo,71,2,3,2,not acept,3700,50,47,3797
Sao Paulo,70,2,1,2,not acept,1400,85,22,1507
Sao Paulo,67,2,1,1,not acept,2600,198,33,2831
Sao Paulo,120,3,2,1,acept,1850,84,28,1962
Sao Paulo,465,5,5,2,acept,8960,1500,135,10595
Rio de Janeiro,120,3,2,0,acept,5000,168,65,5233
Sao Paulo,92,2,1,0,not acept,1790,0,23,1813
Porto Alegre,78,3,2,2,acept,3500,169,52,3721
Campinas,60,2,1,1,acept,1100,84,14,1198
Sao Paulo,100,3,1,1,acept,1400,0,18,1418
Sao Paulo,87,2,3,2,not acept,5700,216,73,5989
Sao Paulo,160,2,2,4,acept,2975,117,45,3137
Sao Paulo,100,2,3,2,acept,4000,375,51,4426
Sao Paulo,52,2,1,1,acept,1300,10,17,1327
Sao Paulo,109,4,2,2,acept,6500,319,83,6902
Rio de Janeiro,26,1,1,0,not acept,1280,0,17,1297
Sao Paulo,270,4,5,2,acept,5500,1115,70,6685
Belo Horizonte,208,3,4,3,acept,6000,338,99,6437
Belo Horizonte,20,1,1,1,not acept,1000,0,14,1014
Sao Paulo,50,2,1,1,acept,1100,11,14,1125
Rio de Janeiro,138,2,1,0,acept,1000,175,13,1188
Campinas,58,2,2,2,not acept,3500,0,45,3545
Sao Paulo,198,3,4,3,acept,8000,917,102,9019
Sao Paulo,115,4,4,3,acept,4000,417,51,4468
Rio de Janeiro,128,3,3,2,acept,13000,726,168,13894
Sao Paulo,66,1,1,0,acept,3000,75,39,3114
Sao Paulo,234,3,5,3,not acept,14000,1334,178,15512
Sao Paulo,380,4,4,6,acept,6000,417,91,6508
Sao Paulo,113,2,1,1,acept,3000,50,39,3089
Sao Paulo,160,3,3,2,acept,2500,192,38,2730
Rio de Janeiro,80,2,1,0,not acept,1100,0,15,1115
Sao Paulo,33,2,1,0,not acept,980,0,15,995
Porto Alegre,50,2,1,1,not acept,1500,0,22,1522
Rio de Janeiro,65,1,1,0,acept,2200,30,29,2259
Sao Paulo,40,1,1,0,acept,850,34,13,897
Sao Paulo,261,3,4,4,acept,15000,834,191,16025
Belo Horizonte,50,2,1,1,acept,1140,0,16,1156
Porto Alegre,281,4,4,2,acept,3500,410,52,3962
Sao Paulo,119,2,1,1,not acept,1700,84,26,1810
Belo Horizonte,52,2,1,1,acept,1000,111,14,1125
Porto Alegre,40,1,1,0,not acept,850,43,13,906
Porto Alegre,47,1,1,0,acept,800,21,12,833
Porto Alegre,35,1,1,0,acept,1000,20,15,1035
Sao Paulo,40,1,1,0,not acept,700,59,11,770
Belo Horizonte,55,2,1,1,acept,750,0,10,760
Rio de Janeiro,72,2,1,1,acept,1200,150,16,1366
Porto Alegre,30,1,1,0,acept,600,17,9,626
Rio de Janeiro,57,1,1,1,acept,11500,959,149,12608
Sao Paulo,70,1,1,1,not acept,1100,0,17,1117
Sao Paulo,63,2,2,1,acept,4500,136,58,4694
Sao Paulo,220,3,4,3,acept,8000,1000,102,9102
Sao Paulo,126,4,3,4,acept,3300,167,50,3517
Porto Alegre,147,2,3,2,acept,7900,75,116,8091
Sao Paulo,70,3,2,1,not acept,1940,77,25,2042
Sao Paulo,99,2,1,1,acept,1800,0,23,1823
Rio de Janeiro,90,3,1,0,acept,1500,140,20,1660
Rio de Janeiro,100,2,1,0,not acept,1700,2,22,1724
Rio de Janeiro,48,1,1,0,acept,1300,25,17,1342
Belo Horizonte,247,4,5,4,acept,12500,1458,167,14125
Sao Paulo,443,5,5,4,acept,7000,1417,89,8506
Rio de Janeiro,200,2,3,2,acept,5200,250,68,5518
Belo Horizonte,360,4,3,4,not acept,6500,181,107,6788
Sao Paulo,20,1,1,0,acept,1800,130,23,1953
Rio de Janeiro,90,3,2,0,acept,2570,242,34,2846
Sao Paulo,297,4,4,6,acept,3000,392,46,3438
Porto Alegre,180,3,3,2,acept,2700,175,40,2915
Sao Paulo,54,1,2,1,acept,6000,0,77,6077
Porto Alegre,90,2,2,1,not acept,2500,80,37,2617
Campinas,105,3,3,2,acept,2300,208,30,2538
Porto Alegre,67,2,1,1,not acept,2500,96,37,2633
Campinas,45,1,1,0,acept,770,34,10,814
Belo Horizonte,33,1,1,1,acept,1600,9,22,1631
Sao Paulo,45,1,1,0,not acept,620,15,8,643
Porto Alegre,127,3,3,0,acept,1125,209,17,1351
Sao Paulo,120,3,3,2,acept,8950,0,114,9064
Sao Paulo,75,2,1,1,acept,1880,16,24,1920
Sao Paulo,220,3,2,3,acept,7800,215,118,8133
Sao Paulo,50,1,1,1,not acept,5000,0,64,5064
Porto Alegre,115,3,2,1,acept,2500,250,37,2787
Campinas,75,2,2,1,acept,2400,75,31,2506
Rio de Janeiro,65,2,2,0,not acept,1305,0,20,1325
Rio de Janeiro,39,1,1,0,not acept,2300,98,30,2428
Sao Paulo,200,2,3,2,acept,4000,196,61,4257
Sao Paulo,72,2,1,0,acept,2560,0,33,2593
Rio de Janeiro,108,2,2,1,not acept,4500,350,58,4908
Sao Paulo,32,1,1,1,acept,4500,128,58,4686
Sao Paulo,106,3,2,1,not acept,3200,260,41,3501
Belo Horizonte,70,3,1,1,acept,1100,100,15,1215
Rio de Janeiro,120,3,2,1,acept,4500,325,58,4883
Campinas,55,1,1,0,acept,500,37,7,544
Sao Paulo,100,3,1,0,acept,1617,0,7,1624
Sao Paulo,162,2,2,1,acept,5000,0,64,5064
Sao Paulo,75,2,1,1,acept,1700,18,22,1740
Campinas,44,1,1,0,acept,670,12,9,691
Sao Paulo,130,2,2,2,not acept,7500,780,96,8376
Campinas,147,4,3,1,acept,3500,62,53,3615
Porto Alegre,70,2,1,0,acept,1150,15,17,1182
Porto Alegre,64,2,2,2,acept,2300,50,34,2384
Rio de Janeiro,180,4,3,1,not acept,4000,482,52,4534
Porto Alegre,42,2,1,0,acept,1200,100,18,1318
Sao Paulo,117,3,3,1,acept,4620,300,59,4979
Rio de Janeiro,180,3,4,2,acept,15000,369,194,15563
Sao Paulo,65,3,2,1,not acept,3250,113,42,3405
Sao Paulo,29,1,1,0,not acept,1720,99,22,1841
Sao Paulo,600,4,6,3,acept,12000,817,181,12998
Sao Paulo,145,3,3,1,acept,11000,375,140,11515
Sao Paulo,310,4,4,4,acept,14000,1751,178,15929
Belo Horizonte,260,4,4,3,not acept,5250,440,70,5760
Sao Paulo,320,3,3,2,acept,8330,584,106,9020
Belo Horizonte,70,3,1,1,acept,980,0,14,994
Rio de Janeiro,35,1,1,0,acept,800,0,11,811
Porto Alegre,320,3,4,4,acept,4950,234,88,5272
Porto Alegre,82,2,2,2,acept,2800,92,41,2933
Sao Paulo,62,2,2,1,acept,2580,84,33,2697
Porto Alegre,60,3,1,0,acept,1550,31,23,1604
Porto Alegre,78,3,2,0,acept,1700,61,25,1786
Sao Paulo,385,4,5,6,acept,7000,2410,89,9499
Porto Alegre,214,3,3,2,acept,3500,500,52,4052
Sao Paulo,233,4,5,4,acept,11000,92,140,11232
Rio de Janeiro,60,2,1,1,acept,1500,50,20,1570
Belo Horizonte,22,1,1,0,not acept,1300,75,18,1393
Rio de Janeiro,100,2,3,0,acept,1700,130,22,1852
Sao Paulo,90,2,1,1,acept,3000,50,39,3089
Rio de Janeiro,60,2,2,0,not acept,2500,83,33,2616
Sao Paulo,22,1,1,0,acept,2100,40,27,2167
Porto Alegre,80,2,1,0,acept,1610,0,24,1634
Sao Paulo,110,3,4,3,acept,2200,403,28,2631
Rio de Janeiro,120,2,2,1,acept,800,18,11,829
Belo Horizonte,193,3,3,1,acept,13500,236,222,13958
Sao Paulo,55,2,1,1,acept,1460,0,19,1479
Rio de Janeiro,165,3,3,1,acept,7000,420,91,7511
Porto Alegre,46,1,1,2,acept,2400,98,36,2534
Rio de Janeiro,55,2,1,0,acept,2200,0,29,2229
Sao Paulo,150,2,2,1,acept,2954,1,45,3000
Sao Paulo,57,1,1,0,acept,6000,17,77,6094
Rio de Janeiro,160,3,2,1,acept,6700,367,87,7154
Sao Paulo,200,4,4,2,acept,7000,850,89,7939
Campinas,60,1,2,1,acept,1338,72,17,1427
Sao Paulo,180,3,2,1,acept,4500,500,58,5058
Sao Paulo,62,1,1,0,acept,2100,0,27,2127
Rio de Janeiro,90,3,2,1,acept,3400,275,44,3719
Rio de Janeiro,35,1,1,0,not acept,2300,92,30,2422
Sao Paulo,95,2,1,1,acept,3200,92,41,3333
Sao Paulo,320,5,5,4,acept,5500,1500,70,7070
Rio de Janeiro,127,3,2,2,acept,1700,124,22,1846
Sao Paulo,210,3,2,2,acept,5000,417,64,5481
Sao Paulo,160,4,3,2,acept,5600,334,71,6005
Sao Paulo,273,3,2,5,not acept,3355,215,51,3621
Sao Paulo,211,4,5,4,acept,3800,714,49,4563
Sao Paulo,145,2,3,2,acept,10000,584,127,10711
Porto Alegre,92,2,2,1,acept,1900,67,28,1995
Campinas,70,2,3,1,acept,2004,0,26,2030
Campinas,254,3,4,2,acept,3000,251,46,3297
Sao Paulo,350,4,4,2,not acept,6000,1316,77,7393
Sao Paulo,55,1,1,0,acept,1177,0,15,1192
Sao Paulo,80,3,2,2,acept,2400,227,31,2658
Sao Paulo,280,3,3,4,acept,4500,1116,58,5674
Sao Paulo,100,3,1,0,acept,1970,0,25,1995
Rio de Janeiro,98,3,2,1,acept,6000,239,78,6317
Sao Paulo,85,2,3,1,acept,3300,94,42,3436
Sao Paulo,78,2,2,2,not acept,3500,155,45,3700
Sao Paulo,58,2,1,1,acept,1800,75,23,1898
Rio de Janeiro,50,1,1,1,acept,2300,420,30,2750
Sao Paulo,30,1,1,0,acept,1600,0,21,1621
Sao Paulo,75,2,1,1,acept,6000,600,77,6677
Campinas,350,4,6,6,acept,7330,55,111,7496
Sao Paulo,136,3,4,3,acept,2800,500,36,3336
Sao Paulo,290,3,3,3,acept,8000,542,121,8663
Sao Paulo,99,2,2,2,acept,4000,122,51,4173
Porto Alegre,750,5,3,6,not acept,7980,46,142,8168
Sao Paulo,110,2,2,1,acept,3500,125,53,3678
Porto Alegre,340,2,3,2,acept,4000,317,59,4376
Sao Paulo,178,2,1,1,not acept,3440,0,44,3484
Belo Horizonte,28,1,1,1,not acept,1250,0,17,1267
Belo Horizonte,38,1,1,0,not acept,1300,0,18,1318
Porto Alegre,254,3,4,2,acept,6150,200,110,6460
Porto Alegre,51,2,1,1,acept,1050,75,16,1141
Sao Paulo,134,3,3,2,acept,3500,390,45,3935
Sao Paulo,38,1,1,1,acept,2170,59,28,2257
Sao Paulo,400,4,5,3,not acept,15000,0,191,15191
Rio de Janeiro,136,3,2,2,acept,8000,558,104,8662
Sao Paulo,250,4,5,2,acept,12000,9,153,12162
Campinas,94,2,2,2,acept,4000,165,51,4216
Rio de Janeiro,62,2,2,1,acept,1750,38,23,1811
Sao Paulo,80,2,2,1,acept,2540,65,39,2644
Campinas,89,3,1,1,not acept,2050,150,26,2226
Campinas,51,2,1,0,acept,980,21,13,1014
Sao Paulo,40,1,1,1,not acept,3899,208,50,4157
Porto Alegre,47,1,1,1,not acept,2200,0,33,2233
Sao Paulo,210,3,5,3,acept,3800,0,49,3849
Sao Paulo,230,4,4,4,acept,13500,1084,172,14756
Sao Paulo,70,2,2,1,acept,2450,59,32,2541
Porto Alegre,117,3,1,1,acept,1550,100,23,1673
Belo Horizonte,54,2,2,0,acept,1100,0,15,1115
Sao Paulo,105,2,1,0,acept,1800,125,28,1953
Rio de Janeiro,47,2,2,0,acept,4210,158,55,4423
Sao Paulo,120,3,1,0,acept,2100,167,27,2294
Rio de Janeiro,284,4,6,2,acept,11420,567,148,12135
Sao Paulo,58,2,1,1,not acept,2493,80,9,2582
Porto Alegre,95,2,1,1,acept,2800,69,41,2910
Rio de Janeiro,65,2,1,0,acept,1000,47,16,1063
Porto Alegre,188,3,4,2,acept,3800,0,68,3868
Belo Horizonte,21,1,1,0,not acept,850,60,12,922
Sao Paulo,65,2,2,1,not acept,3200,0,41,3241
Rio de Janeiro,50,2,1,0,acept,1660,42,22,1724
Sao Paulo,150,4,3,3,acept,7500,109,113,7722
Porto Alegre,90,3,3,1,acept,2500,91,37,2628
Belo Horizonte,400,3,3,6,acept,7200,218,119,7537
Campinas,64,2,2,2,acept,1964,134,8,2106
Sao Paulo,80,2,1,1,not acept,2156,0,28,2184
Sao Paulo,300,3,5,4,not acept,6000,1974,77,8051
Sao Paulo,240,3,3,2,acept,3840,152,58,4050
Sao Paulo,50,2,1,1,not acept,1357,0,6,1363
Sao Paulo,820,4,4,6,acept,13000,2500,196,15696
Porto Alegre,58,1,1,1,acept,2300,139,34,2473
Sao Paulo,230,3,2,2,acept,1965,441,25,2431
Porto Alegre,43,1,1,1,acept,2450,107,36,2593
Sao Paulo,280,6,6,3,acept,5000,1118,76,6194
Sao Paulo,54,2,1,1,acept,1350,0,18,1368
Belo Horizonte,200,6,2,1,acept,3400,134,56,3590
Sao Paulo,360,3,5,6,acept,3000,4830,39,7869
Sao Paulo,650,5,8,7,acept,15000,2667,226,17893
Porto Alegre,38,1,1,0,acept,850,34,13,897
Belo Horizonte,373,4,5,5,acept,15000,188,200,15388
Porto Alegre,47,1,1,1,not acept,2200,0,33,2233
Sao Paulo,133,3,2,2,acept,4300,255,65,4620
Belo Horizonte,150,4,2,2,acept,3700,211,50,3961
Campinas,80,3,2,1,acept,1200,74,16,1290
Sao Paulo,129,4,2,3,acept,5500,520,70,6090
Sao Paulo,275,3,5,6,acept,13000,500,196,13696
Rio de Janeiro,44,1,1,0,acept,1700,86,22,1808
Belo Horizonte,60,1,2,1,acept,1900,163,26,2089
Belo Horizonte,170,3,4,4,acept,8000,759,107,8866
Sao Paulo,40,1,1,2,acept,1559,169,20,1748
Belo Horizonte,200,4,4,4,acept,4100,963,55,5118
Sao Paulo,170,4,4,3,acept,2499,870,32,3401
Sao Paulo,200,5,3,2,acept,9000,259,115,9374
Sao Paulo,31,1,1,0,not acept,1900,0,25,1925
Porto Alegre,135,3,2,1,acept,2165,209,32,2406
Sao Paulo,400,3,3,1,acept,11000,142,140,11282
Porto Alegre,70,2,1,0,acept,1200,65,18,1283
Sao Paulo,64,1,1,0,acept,1750,0,23,1773
Rio de Janeiro,73,2,1,1,acept,1200,119,16,1335
Sao Paulo,240,3,4,3,acept,5100,1102,65,6267
Sao Paulo,115,2,1,1,acept,1750,134,27,1911
Sao Paulo,400,3,4,3,acept,10000,1189,151,11340
Sao Paulo,147,4,2,0,acept,2800,258,36,3094
Belo Horizonte,58,2,1,1,acept,750,80,10,840
Campinas,92,3,2,2,acept,2000,145,26,2171
Sao Paulo,330,3,6,4,acept,8500,856,128,9484
Porto Alegre,60,2,1,0,acept,850,320,13,1183
Sao Paulo,240,4,5,4,acept,6000,834,77,6911
Porto Alegre,38,1,1,0,acept,800,43,12,855
Sao Paulo,141,3,2,2,acept,6900,450,88,7438
Porto Alegre,43,1,1,1,not acept,2790,120,41,2951
Porto Alegre,62,2,1,0,acept,940,38,14,992
Campinas,50,2,1,1,not acept,1500,35,20,1555
Porto Alegre,75,2,1,1,acept,1200,34,18,1252
Sao Paulo,180,3,2,1,acept,5400,459,82,5941
Campinas,33,1,1,0,not acept,600,10,8,618
Sao Paulo,580,6,6,8,acept,10000,2800,151,12951
Sao Paulo,136,3,3,2,not acept,3200,525,41,3766
Sao Paulo,238,4,4,3,not acept,5000,1220,64,6284
Sao Paulo,109,3,2,2,acept,4500,417,58,4975
Sao Paulo,90,2,1,0,acept,2400,170,37,2607
Porto Alegre,171,2,2,1,acept,2200,200,33,2433
Sao Paulo,40,1,1,0,acept,1105,0,14,1119
Campinas,119,3,2,2,acept,1200,212,16,1428
Belo Horizonte,330,5,7,5,acept,4800,973,64,5837
Sao Paulo,60,1,1,1,acept,4600,115,59,4774
Sao Paulo,118,3,2,1,acept,6000,22,77,6099
Sao Paulo,134,2,2,1,not acept,3400,239,44,3683
Sao Paulo,280,3,4,1,acept,3700,100,56,3856
Sao Paulo,120,3,2,1,acept,1800,109,28,1937
Sao Paulo,288,4,6,4,acept,4200,1155,54,5409
Sao Paulo,180,3,3,2,acept,4000,409,51,4460
Sao Paulo,43,1,1,1,acept,3000,11,39,3050
Sao Paulo,57,1,1,0,acept,6000,17,77,6094
Sao Paulo,200,3,3,0,acept,4500,71,68,4639
Sao Paulo,96,3,3,0,acept,3572,30,46,3648
Sao Paulo,320,4,5,4,acept,6500,417,98,7015
Belo Horizonte,110,3,2,2,acept,2150,192,29,2371
Sao Paulo,35,1,1,1,not acept,3290,124,42,3456
Sao Paulo,270,4,5,6,acept,11000,400,166,11566
Sao Paulo,85,2,1,1,not acept,1200,74,16,1290
Sao Paulo,60,2,2,1,acept,3000,209,39,3248
Sao Paulo,550,4,5,5,acept,5000,875,76,5951
Sao Paulo,45,1,1,0,not acept,3800,81,49,3930
Sao Paulo,130,3,2,2,acept,5100,183,77,5360
Rio de Janeiro,50,1,1,0,acept,800,0,11,811
Sao Paulo,55,2,1,1,acept,1800,42,23,1865
Porto Alegre,47,1,1,1,not acept,2200,0,33,2233
Belo Horizonte,192,4,3,3,acept,2400,196,32,2628
Sao Paulo,70,2,2,2,acept,1800,59,23,1882
Porto Alegre,78,2,1,0,acept,1480,32,22,1534
Porto Alegre,45,1,1,1,acept,900,84,14,998
Belo Horizonte,250,2,2,1,acept,900,67,15,982
Rio de Janeiro,90,3,1,0,acept,2240,42,29,2311
Rio de Janeiro,186,3,4,2,acept,13000,475,168,13643
Sao Paulo,33,1,1,0,acept,3999,0,51,4050
Porto Alegre,250,5,4,5,acept,4300,84,77,4461
Rio de Janeiro,30,1,1,0,not acept,1750,79,23,1852
Rio de Janeiro,106,3,1,0,acept,2000,80,26,2106
Sao Paulo,72,2,2,1,acept,3000,93,39,3132
Sao Paulo,90,2,1,1,acept,3000,50,39,3089
Sao Paulo,102,3,2,1,acept,3315,75,42,3432
Sao Paulo,126,3,3,2,not acept,2500,317,32,2849
Sao Paulo,220,3,2,1,acept,5000,500,76,5576
Porto Alegre,42,1,1,1,acept,2300,50,34,2384
Sao Paulo,69,2,1,1,acept,1600,0,21,1621
Sao Paulo,50,2,1,1,acept,1490,0,19,1509
Sao Paulo,120,4,3,2,acept,2210,334,28,2572
Sao Paulo,160,3,3,3,acept,3500,63,45,3608
Sao Paulo,31,1,1,0,acept,2900,0,37,2937
Sao Paulo,70,3,1,1,acept,1100,0,14,1114
Sao Paulo,37,1,1,1,acept,4000,90,51,4141
Sao Paulo,63,1,1,1,not acept,7400,286,94,7780
Rio de Janeiro,57,2,1,0,acept,1500,54,20,1574
Sao Paulo,400,3,2,3,acept,5500,1084,83,6667
Sao Paulo,370,4,5,6,acept,14000,1900,178,16078
Rio de Janeiro,255,4,3,0,acept,4500,692,58,5250
Sao Paulo,110,2,2,1,acept,2700,1144,35,3879
Rio de Janeiro,82,2,2,1,acept,2400,334,31,2765
Rio de Janeiro,25,1,1,1,acept,2805,417,37,3259
Sao Paulo,65,2,2,1,acept,1750,83,23,1856
Belo Horizonte,45,1,1,0,acept,800,108,11,919
Rio de Janeiro,95,2,2,2,acept,6300,267,82,6649
Rio de Janeiro,55,1,2,1,acept,1200,55,16,1271
Belo Horizonte,96,3,2,2,acept,2300,294,31,2625
Sao Paulo,72,2,1,2,acept,3200,35,41,3276
Belo Horizonte,44,2,1,0,not acept,895,0,12,907
Belo Horizonte,2000,3,3,2,acept,5000,200,67,5267
Sao Paulo,49,2,1,1,acept,1500,0,20,1520
Sao Paulo,119,3,2,1,acept,3500,247,45,3792
Sao Paulo,52,1,1,1,acept,2000,89,26,2115
Sao Paulo,80,2,1,1,acept,1300,0,17,1317
Sao Paulo,200,3,3,3,acept,5000,835,64,5899
Sao Paulo,181,3,4,3,not acept,8000,903,102,9005
Belo Horizonte,220,4,3,2,acept,2700,269,36,3005
Porto Alegre,125,3,3,1,acept,2400,184,36,2620
Campinas,55,1,1,0,acept,915,57,12,984
Porto Alegre,28,1,1,0,acept,1200,10,18,1228
Porto Alegre,48,2,1,1,acept,1100,27,17,1144
Sao Paulo,222,4,3,4,acept,6500,1000,83,7583
Sao Paulo,138,3,3,2,acept,2700,141,41,2882
Sao Paulo,72,2,1,1,acept,1701,155,22,1878
Sao Paulo,171,4,4,4,acept,10000,85,127,10212
Rio de Janeiro,55,1,2,1,acept,2750,50,36,2836
Rio de Janeiro,120,2,3,1,acept,2600,225,34,2859
Sao Paulo,102,3,3,2,acept,3990,150,51,4191
Sao Paulo,118,3,3,2,acept,3500,534,45,4079
Sao Paulo,55,2,1,0,not acept,1260,0,16,1276
Porto Alegre,197,4,3,2,acept,3200,325,47,3572
Sao Paulo,49,1,1,0,not acept,1350,0,21,1371
Rio de Janeiro,45,1,1,0,not acept,3300,249,43,3592
Campinas,104,2,2,2,acept,4200,210,54,4464
Campinas,73,3,2,2,acept,2400,125,31,2556
Porto Alegre,55,1,1,0,acept,1150,30,17,1197
Sao Paulo,202,4,4,3,acept,6000,1000,77,7077
Sao Paulo,54,2,1,1,acept,1650,50,21,1721
Sao Paulo,75,2,1,0,not acept,1200,67,16,1283
Rio de Janeiro,89,3,2,0,acept,2750,138,36,2924
Sao Paulo,46,1,1,0,acept,1800,0,23,1823
Sao Paulo,386,4,6,4,acept,4250,667,64,4981
Porto Alegre,240,3,3,1,acept,4000,392,72,4464
Sao Paulo,61,3,2,1,acept,3000,117,39,3156
Sao Paulo,80,2,2,1,acept,2200,0,28,2228
Belo Horizonte,45,2,1,1,acept,1300,39,18,1357
Sao Paulo,18,1,1,0,acept,1720,0,22,1742
Sao Paulo,30,1,1,1,acept,2580,83,33,2696
Sao Paulo,300,4,4,6,acept,3800,33,49,3882
Sao Paulo,69,1,1,1,acept,1200,100,16,1316
Campinas,157,3,2,2,acept,2200,208,28,2436
Rio de Janeiro,30,1,1,0,acept,700,0,10,710
Belo Horizonte,32,1,1,0,not acept,1000,100,14,1114
Belo Horizonte,83,3,2,2,acept,1600,130,22,1752
Sao Paulo,55,2,2,2,acept,2001,142,26,2169
Sao Paulo,70,1,1,1,acept,2500,150,32,2682
Sao Paulo,20,1,1,0,not acept,3142,67,40,3249
Belo Horizonte,298,4,2,3,acept,3044,186,50,3280
Belo Horizonte,90,3,2,1,acept,1300,100,18,1418
Sao Paulo,147,2,2,1,acept,4000,314,51,4365
Sao Paulo,48,1,1,1,acept,2000,0,26,2026
Sao Paulo,32,1,1,1,not acept,3400,150,44,3594
Sao Paulo,195,4,2,3,acept,2500,307,32,2839
Campinas,350,4,3,4,not acept,6000,500,91,6591
Sao Paulo,74,2,1,0,not acept,2500,1,32,2533
Sao Paulo,130,3,2,2,not acept,3250,571,42,3863
Campinas,60,2,3,0,not acept,1940,0,25,1965
Belo Horizonte,55,2,1,1,not acept,1300,119,18,1437
Sao Paulo,89,3,2,2,acept,1540,115,20,1675
Porto Alegre,70,2,2,2,acept,3300,115,49,3464
Belo Horizonte,141,4,2,1,acept,3000,117,50,3167
Belo Horizonte,260,4,2,2,acept,2500,251,41,2792
Sao Paulo,168,4,2,2,acept,3100,130,47,3277
Belo Horizonte,24,1,1,1,not acept,550,0,10,560
Sao Paulo,240,4,4,5,acept,4500,750,58,5308
Sao Paulo,178,3,4,4,acept,10000,125,127,10252
Sao Paulo,58,2,1,1,acept,2380,120,31,2531
Sao Paulo,800,4,7,8,not acept,8500,209,128,8837
Sao Paulo,180,3,2,2,acept,7000,730,89,7819
Sao Paulo,101,3,4,2,not acept,6140,359,78,6577
Sao Paulo,50,1,1,0,not acept,830,0,11,841
Belo Horizonte,55,2,1,1,acept,600,67,8,675
Sao Paulo,120,2,3,2,acept,5400,0,82,5482
Campinas,42,2,1,1,not acept,600,15,8,623
Belo Horizonte,40,1,1,1,not acept,860,0,12,872
Sao Paulo,78,2,2,2,acept,5800,334,74,6208
Porto Alegre,144,3,2,1,acept,2740,269,41,3050
Rio de Janeiro,70,3,1,1,acept,1200,71,16,1287
Campinas,440,4,4,4,not acept,4000,417,61,4478
Porto Alegre,44,1,1,1,acept,1250,65,19,1334
Sao Paulo,596,4,5,2,acept,15000,2620,226,17846
Porto Alegre,230,3,4,3,acept,10000,417,178,10595
Belo Horizonte,100,2,1,0,acept,1200,1680,16,2896
Sao Paulo,300,3,3,8,acept,5500,286,83,5869
Sao Paulo,47,2,1,0,acept,1900,0,8,1908
Campinas,105,3,2,2,acept,1620,165,21,1806
Sao Paulo,65,2,2,1,not acept,1300,3,17,1320
Sao Paulo,65,3,2,1,acept,1860,135,24,2019
Sao Paulo,60,2,2,2,acept,2100,344,27,2471
Campinas,314,3,4,3,acept,4000,349,61,4410
Sao Paulo,70,2,1,0,acept,1800,92,23,1915
Rio de Janeiro,80,3,2,1,acept,1450,0,19,1469
Sao Paulo,350,3,5,5,acept,5500,675,83,6258
Porto Alegre,52,1,1,0,acept,900,0,14,914
Sao Paulo,380,4,5,6,acept,4900,1737,63,6700
Rio de Janeiro,70,1,1,0,acept,2400,263,31,2694
Sao Paulo,45,2,1,1,acept,2364,77,30,2471
Sao Paulo,44,1,1,1,acept,2930,205,38,3173
Sao Paulo,142,4,4,3,not acept,2870,559,37,3466
Belo Horizonte,96,3,1,1,acept,2200,154,30,2384
Sao Paulo,88,2,3,2,acept,2803,496,36,3335
Sao Paulo,169,3,4,3,acept,8900,590,113,9603
Rio de Janeiro,40,1,1,0,acept,900,0,12,912
Sao Paulo,45,1,1,0,not acept,950,0,15,965
Rio de Janeiro,320,3,2,0,not acept,6000,292,78,6370
Sao Paulo,82,1,2,1,not acept,11000,25,140,11165
Sao Paulo,180,3,4,3,acept,8900,782,113,9795
Sao Paulo,340,4,4,4,acept,8500,1400,108,10008
Belo Horizonte,100,3,3,1,acept,2300,206,31,2537
Sao Paulo,160,3,3,3,acept,10000,584,127,10711
Sao Paulo,160,4,4,3,acept,6500,858,83,7441
Campinas,100,3,2,2,acept,1200,80,16,1296
Sao Paulo,33,1,1,1,not acept,4150,95,53,4298
Sao Paulo,35,1,2,1,acept,1870,0,7,1877
Porto Alegre,52,2,2,1,acept,1900,42,28,1970
Sao Paulo,180,3,2,2,acept,5500,518,70,6088
Sao Paulo,180,3,2,1,not acept,3000,163,46,3209
Sao Paulo,300,4,4,4,acept,10000,1167,127,11294
Sao Paulo,79,2,1,0,acept,2050,218,26,2294
Porto Alegre,66,2,1,0,acept,1300,42,19,1361
Sao Paulo,26,1,1,0,not acept,2060,0,27,2087
Sao Paulo,367,4,5,6,not acept,8000,2110,102,10212
Campinas,60,2,1,1,acept,900,74,12,986
Sao Paulo,80,2,3,1,acept,1800,0,28,1828
Rio de Janeiro,50,2,1,0,acept,1170,70,18,1258
Rio de Janeiro,100,3,1,0,acept,1250,138,17,1405
Sao Paulo,250,3,4,3,acept,6000,834,77,6911
Porto Alegre,40,1,1,1,not acept,1200,68,18,1286
Sao Paulo,68,2,2,1,not acept,2400,125,31,2556
Sao Paulo,35,1,1,1,not acept,2000,275,26,2301
Porto Alegre,46,2,1,1,acept,750,16,11,777
Sao Paulo,21,1,1,0,acept,3200,42,41,3283
Rio de Janeiro,45,1,1,0,acept,3900,0,51,3951
Belo Horizonte,107,3,2,2,acept,2400,184,32,2616
Sao Paulo,220,3,3,5,acept,7500,0,113,7613
Sao Paulo,380,5,7,4,acept,8000,775,121,8896
Sao Paulo,150,3,3,2,not acept,4000,417,51,4468
Rio de Janeiro,15,1,1,0,not acept,1000,0,13,1013
Sao Paulo,35,1,1,0,not acept,1305,0,17,1322
Sao Paulo,120,3,4,2,acept,3000,670,39,3709
Sao Paulo,24,2,2,1,acept,5500,141,70,5711
Porto Alegre,70,2,2,1,acept,2720,75,40,2835
Porto Alegre,50,1,2,0,acept,1100,0,17,1117
Sao Paulo,220,3,4,4,acept,7000,1000,89,8089
Sao Paulo,180,3,4,3,acept,3500,65,45,3610
Porto Alegre,148,3,2,3,acept,3000,167,44,3211
Sao Paulo,52,2,1,1,acept,1340,8,17,1365
Porto Alegre,48,2,1,0,acept,700,0,11,711
Sao Paulo,160,4,5,2,acept,6800,500,87,7387
Sao Paulo,40,1,1,0,acept,1000,56,13,1069
Sao Paulo,40,1,1,0,not acept,2500,0,32,2532
Campinas,143,3,2,3,acept,1700,70,26,1796
Campinas,550,3,4,8,acept,4600,380,70,5050
Sao Paulo,35,1,1,1,not acept,4200,17,54,4271
Porto Alegre,50,2,1,0,acept,1300,0,19,1319
Sao Paulo,210,4,4,3,acept,9100,667,116,9883
Sao Paulo,60,2,2,2,acept,1840,165,24,2029
Sao Paulo,217,4,4,3,acept,5000,1550,64,6614
Rio de Janeiro,300,3,3,2,acept,11330,3334,146,14810
Rio de Janeiro,45,1,1,0,acept,2000,45,31,2076
Sao Paulo,230,5,3,0,acept,7200,343,109,7652
Campinas,139,3,5,3,acept,6700,232,85,7017
Sao Paulo,48,2,1,0,acept,1350,0,18,1368
Sao Paulo,145,3,3,3,acept,12000,667,153,12820
Porto Alegre,65,1,1,0,acept,1350,525,20,1895
Porto Alegre,180,3,3,2,acept,2700,250,40,2990
Sao Paulo,438,5,6,5,not acept,12000,817,181,12998
Sao Paulo,100,2,2,1,acept,1979,225,26,2230
Rio de Janeiro,430,4,4,2,acept,10000,1119,129,11248
Sao Paulo,315,4,5,5,not acept,4000,1000,29,5029
Porto Alegre,374,3,4,2,acept,8250,473,147,8870
Sao Paulo,270,3,2,1,acept,3920,34,50,4004
Campinas,92,2,3,2,not acept,4200,275,54,4529
Porto Alegre,220,3,3,2,not acept,10000,542,147,10689
Sao Paulo,243,4,3,3,acept,2000,1324,26,3350
Porto Alegre,240,3,3,7,acept,3400,349,61,3810
Sao Paulo,260,4,5,5,acept,15000,0,191,15191
Porto Alegre,63,3,2,2,acept,2050,54,30,2134
Sao Paulo,238,4,5,3,not acept,15000,375,58,15433
Sao Paulo,60,2,2,2,acept,1900,90,25,2015
Sao Paulo,82,2,2,0,not acept,1600,5,21,1626
Campinas,74,3,1,1,acept,1000,54,13,1067
Belo Horizonte,40,1,1,2,not acept,3500,63,47,3610
Porto Alegre,70,3,1,1,acept,1100,0,17,1117
Belo Horizonte,83,3,2,3,acept,2050,198,28,2276
Sao Paulo,55,2,1,0,acept,1350,0,18,1368
Sao Paulo,290,3,2,2,not acept,8000,1334,121,9455
Rio de Janeiro,250,5,3,4,acept,5000,417,77,5494
Sao Paulo,350,4,3,4,acept,7500,959,96,8555
Sao Paulo,330,5,4,2,acept,7650,720,115,8485
Campinas,82,3,3,2,acept,1500,153,20,1673
Sao Paulo,60,2,2,1,acept,1420,59,18,1497
Rio de Janeiro,74,2,1,0,acept,1900,212,25,2137
Belo Horizonte,160,3,3,2,acept,2400,244,32,2676
Porto Alegre,483,4,4,0,acept,4900,1167,72,6139
Sao Paulo,35,1,1,0,acept,2999,103,38,3140
Sao Paulo,285,4,4,3,not acept,4500,359,58,4917
Belo Horizonte,50,2,1,1,acept,1100,28,15,1143
Rio de Janeiro,77,2,2,0,acept,1950,88,26,2064
Sao Paulo,76,2,2,1,not acept,1600,33,21,1654
Porto Alegre,200,2,1,0,acept,2800,0,50,2850
Sao Paulo,300,5,4,5,acept,8500,60,128,8688
Rio de Janeiro,105,3,2,1,acept,12000,459,155,12614
Campinas,55,1,1,1,acept,700,45,9,754
Porto Alegre,75,2,2,1,acept,1650,100,25,1775
Campinas,276,3,4,3,acept,7000,594,89,7683
Belo Horizonte,70,2,2,1,acept,1050,100,14,1164
Sao Paulo,460,7,5,5,acept,9000,3129,136,12265
Rio de Janeiro,135,4,2,2,acept,6489,467,84,7040
Belo Horizonte,64,2,1,1,not acept,1200,0,16,1216
Belo Horizonte,76,2,1,1,acept,700,59,10,769
Sao Paulo,170,6,4,4,acept,7200,0,109,7309
Belo Horizonte,85,2,1,1,not acept,2150,198,29,2377
Campinas,49,2,1,1,acept,1000,0,13,1013
Rio de Janeiro,128,4,2,0,not acept,2000,10,26,2036
Sao Paulo,96,3,2,2,acept,1610,162,21,1793
Rio de Janeiro,45,1,1,1,acept,3000,382,39,3421
Sao Paulo,32,1,1,1,not acept,3250,300,42,3592
Porto Alegre,37,1,1,0,acept,1500,69,22,1591
Belo Horizonte,335,4,4,4,acept,10000,678,164,10842
Rio de Janeiro,56,2,1,1,acept,1500,90,20,1610
Sao Paulo,330,1,3,8,acept,3147,0,48,3195
Rio de Janeiro,21,1,1,0,acept,2800,0,37,2837
Sao Paulo,300,5,5,4,acept,6500,525,98,7123
Porto Alegre,373,4,4,4,acept,6800,100,121,7021
Sao Paulo,53,2,1,1,not acept,1200,60,16,1276
Sao Paulo,156,3,3,3,acept,4900,917,63,5880
Porto Alegre,80,2,1,0,not acept,1250,0,19,1269
Sao Paulo,74,2,2,2,not acept,3300,270,42,3612
Sao Paulo,103,3,2,1,acept,4200,250,64,4514
Belo Horizonte,458,8,10,4,acept,7000,419,115,7534
Belo Horizonte,98,2,1,0,not acept,1500,58,25,1583
Sao Paulo,40,1,1,0,acept,1000,6,16,1022
Sao Paulo,65,1,1,0,not acept,1300,63,17,1380
Sao Paulo,70,1,1,0,not acept,1300,17,17,1334
Porto Alegre,55,1,1,1,not acept,3200,30,47,3277
Sao Paulo,129,3,4,3,acept,2500,434,32,2966
Porto Alegre,46,1,1,1,acept,750,15,11,776
Porto Alegre,225,4,4,2,acept,4445,352,79,4876
Sao Paulo,215,3,1,1,acept,4000,240,51,4291
Sao Paulo,100,3,3,2,not acept,2000,0,31,2031
Campinas,68,1,1,1,not acept,1000,48,13,1061
Sao Paulo,82,3,1,1,not acept,1500,107,20,1627
Rio de Janeiro,90,2,3,0,acept,2150,60,28,2238
Sao Paulo,250,5,2,6,acept,9000,1417,136,10553
Sao Paulo,392,4,4,4,acept,10000,1250,151,11401
Rio de Janeiro,134,3,4,2,acept,7000,466,91,7557
Campinas,53,2,1,1,acept,510,16,7,533
Rio de Janeiro,165,2,2,0,acept,2500,11,33,2544
Sao Paulo,59,2,1,1,not acept,1400,417,18,1835
Porto Alegre,55,1,1,1,acept,900,50,14,964
Rio de Janeiro,80,2,2,1,not acept,1809,226,9,2044
Rio de Janeiro,71,2,1,1,acept,3140,190,41,3371
Porto Alegre,200,3,3,2,acept,5980,175,107,6262
Sao Paulo,47,1,1,0,acept,1200,26,16,1242
Sao Paulo,78,1,1,2,not acept,6000,317,77,6394
Porto Alegre,70,2,1,0,acept,1750,0,26,1776
Belo Horizonte,44,1,1,1,acept,3500,225,47,3772
Sao Paulo,56,2,1,1,acept,1500,40,20,1560
Belo Horizonte,70,3,2,2,not acept,1560,80,21,1661
Sao Paulo,150,3,3,2,acept,4000,142,51,4193
Rio de Janeiro,60,1,1,0,not acept,2000,192,26,2218
Belo Horizonte,200,3,4,4,acept,5500,1021,74,6595
Sao Paulo,250,4,5,4,not acept,10000,0,127,10127
Sao Paulo,250,4,5,3,acept,5000,565,76,5641
Porto Alegre,40,1,1,1,acept,1180,20,18,1218
Sao Paulo,117,4,5,4,not acept,3175,711,41,3927
Campinas,104,3,1,0,not acept,650,69,9,728
Rio de Janeiro,120,3,1,0,not acept,4500,234,58,4792
Belo Horizonte,125,3,2,0,acept,2968,274,40,3282
Sao Paulo,33,2,1,0,acept,1900,0,25,1925
Rio de Janeiro,99,3,2,1,acept,3500,192,46,3738
Sao Paulo,63,1,1,0,acept,2600,0,33,2633
Rio de Janeiro,43,2,1,0,acept,2000,63,26,2089
Sao Paulo,61,2,2,2,not acept,3160,270,41,3471
Rio de Janeiro,76,2,2,1,acept,3700,167,48,3915
Porto Alegre,52,2,1,1,acept,950,84,14,1048
Sao Paulo,39,1,1,0,acept,1700,0,22,1722
Porto Alegre,126,3,1,1,acept,2200,125,33,2358
Sao Paulo,305,2,3,0,acept,5000,667,64,5731
Sao Paulo,80,2,2,0,not acept,2700,0,35,2735
Rio de Janeiro,85,2,1,1,acept,1700,100,22,1822
Porto Alegre,74,3,2,2,acept,2300,58,34,2392
Rio de Janeiro,130,3,2,1,not acept,2300,172,30,2502
Sao Paulo,113,3,2,1,acept,3000,50,39,3089
Sao Paulo,108,2,1,3,acept,5000,260,76,5336
Sao Paulo,270,4,4,4,acept,10800,800,163,11763
Sao Paulo,111,3,4,3,acept,2700,704,35,3439
Rio de Janeiro,142,3,2,1,acept,2868,247,37,3152
Porto Alegre,48,1,1,1,acept,1100,16,17,1133
Sao Paulo,76,3,2,2,acept,2500,37,32,2569
Sao Paulo,42,1,1,0,not acept,2260,147,29,2436
Sao Paulo,500,4,5,4,not acept,12750,2087,192,15029
Sao Paulo,375,4,4,4,not acept,4700,3025,60,7785
Rio de Janeiro,690,4,5,2,not acept,9500,1301,123,10924
Sao Paulo,172,4,4,3,acept,7500,792,96,8388
Rio de Janeiro,15,1,1,0,acept,700,0,10,710
Rio de Janeiro,130,3,2,2,acept,6500,415,84,6999
Sao Paulo,90,3,2,2,acept,1700,225,22,1947
Campinas,68,3,2,2,acept,2700,76,35,2811
Sao Paulo,260,4,4,4,acept,14000,1834,211,16045
Sao Paulo,87,2,3,2,acept,3560,492,46,4098
Sao Paulo,80,2,1,0,not acept,1500,0,23,1523
Sao Paulo,20,1,1,0,acept,1800,130,23,1953
Sao Paulo,140,2,1,2,acept,5000,584,76,5660
Sao Paulo,45,2,1,1,acept,1300,64,17,1381
Campinas,230,3,4,4,acept,10000,715,127,10842
Sao Paulo,125,3,3,2,acept,3000,650,39,3689
Rio de Janeiro,80,2,1,0,not acept,1360,9,18,1387
Sao Paulo,22,1,1,1,acept,4500,150,58,4708
Campinas,280,4,3,3,acept,2167,169,33,2369
Sao Paulo,126,3,4,3,acept,3200,579,41,3820
Porto Alegre,64,3,2,1,acept,1620,0,24,1644
Rio de Janeiro,70,2,1,1,acept,3800,125,49,3974
Sao Paulo,65,2,1,0,acept,1200,34,19,1253
Porto Alegre,98,3,1,0,acept,1050,84,16,1150
Belo Horizonte,136,3,3,2,acept,2700,234,36,2970
Sao Paulo,80,2,2,2,acept,2465,0,38,2503
Porto Alegre,54,2,1,1,acept,1000,50,15,1065
Porto Alegre,55,1,1,1,acept,1000,50,15,1065
Rio de Janeiro,190,3,2,1,acept,5100,417,66,5583
Sao Paulo,130,3,2,2,acept,6500,338,83,6921
Sao Paulo,54,2,1,1,acept,1932,73,8,2013
Sao Paulo,200,3,4,4,not acept,12000,1167,153,13320
Sao Paulo,150,3,3,2,not acept,3600,499,46,4145
Sao Paulo,205,3,4,4,acept,6000,650,77,6727
Sao Paulo,310,3,3,2,not acept,10400,0,157,10557
Sao Paulo,250,3,4,4,acept,4500,334,68,4902
Sao Paulo,60,2,1,1,acept,1100,0,14,1114
Sao Paulo,66,2,2,1,acept,2980,0,38,3018
Sao Paulo,176,3,4,3,not acept,9500,584,121,10205
Porto Alegre,48,1,1,0,acept,1300,34,19,1353
Rio de Janeiro,90,2,1,0,acept,3490,234,45,3769
Porto Alegre,67,2,2,1,acept,1700,0,25,1725
Belo Horizonte,55,2,1,1,not acept,900,0,12,912
Sao Paulo,50,2,2,1,acept,1550,100,20,1670
Rio de Janeiro,140,3,1,1,acept,4090,0,53,4143
Rio de Janeiro,18,1,1,0,not acept,880,101,12,993
Belo Horizonte,120,4,3,2,acept,3250,0,44,3294
Campinas,50,1,1,0,not acept,850,15,11,876
Sao Paulo,220,3,4,3,acept,4600,126,70,4796
Sao Paulo,25,1,1,1,not acept,3070,700,39,3809
Belo Horizonte,230,4,2,1,acept,2850,190,38,3078
Sao Paulo,80,2,1,0,acept,2200,0,34,2234
Sao Paulo,180,3,3,2,acept,7000,292,89,7381
Rio de Janeiro,62,2,1,0,acept,1300,0,20,1320
Porto Alegre,440,3,2,3,not acept,10500,84,154,10738
Sao Paulo,200,3,3,3,acept,4790,876,61,5727
Porto Alegre,180,3,2,3,acept,5100,250,75,5425
Porto Alegre,300,8,3,0,acept,5100,250,91,5441
Belo Horizonte,360,6,2,0,acept,6000,688,99,6787
Rio de Janeiro,55,2,2,0,acept,2000,220,26,2246
Sao Paulo,400,4,6,4,acept,15000,1875,226,17101
Sao Paulo,19,1,1,0,not acept,1200,41,16,1257
Porto Alegre,326,4,7,4,acept,4200,184,64,4448
Sao Paulo,240,4,4,3,acept,2000,2000,26,4026
Campinas,35,1,1,0,acept,1600,0,25,1625
Rio de Janeiro,110,3,1,0,acept,1800,131,24,1955
Sao Paulo,103,2,3,2,acept,9000,500,115,9615
Sao Paulo,273,3,5,4,acept,10900,1057,139,12096
Sao Paulo,250,4,5,2,acept,8000,338,121,8459
Porto Alegre,67,2,2,1,acept,1240,55,19,1314
Sao Paulo,45,1,1,1,acept,4850,334,62,5246
Sao Paulo,19,1,1,0,not acept,1200,0,16,1216
Rio de Janeiro,90,3,2,1,acept,2050,230,27,2307
Sao Paulo,143,3,3,2,acept,8400,539,107,9046
Sao Paulo,75,2,1,1,not acept,2380,196,31,2607
Rio de Janeiro,115,3,2,1,acept,2900,317,38,3255
Belo Horizonte,100,3,2,2,not acept,2300,165,31,2496
Sao Paulo,63,2,2,1,acept,4400,136,56,4592
Rio de Janeiro,70,2,2,1,acept,2500,230,33,2763
Belo Horizonte,80,3,2,2,not acept,2500,126,34,2660
Sao Paulo,215,3,4,2,acept,5000,318,76,5394
Campinas,75,3,2,1,not acept,2125,67,27,2219
Sao Paulo,35,1,1,0,not acept,1305,0,17,1322
Sao Paulo,400,3,5,4,acept,3500,1419,45,4964
Porto Alegre,109,4,2,3,acept,1950,63,29,2042
Rio de Janeiro,75,2,2,1,acept,1800,84,24,1908
Sao Paulo,23,1,1,0,acept,2150,0,28,2178
Sao Paulo,172,4,3,2,acept,8300,180,106,8586
Sao Paulo,73,2,2,1,acept,2160,105,28,2293
Porto Alegre,25,1,1,0,not acept,750,22,11,783
Campinas,56,2,1,1,acept,1050,24,14,1088
Sao Paulo,96,2,1,2,acept,1648,80,21,1749
Sao Paulo,240,3,2,3,acept,5900,500,89,6489
Sao Paulo,57,2,1,1,acept,3500,135,45,3680
Rio de Janeiro,130,3,2,1,acept,8700,650,113,9463
Sao Paulo,35,1,1,1,not acept,2800,205,36,3041
Sao Paulo,115,3,2,1,acept,2300,195,30,2525
Porto Alegre,45,2,1,0,acept,1040,42,16,1098
Rio de Janeiro,40,1,1,0,not acept,2390,114,31,2535
Rio de Janeiro,95,3,1,1,acept,3500,230,46,3776
Sao Paulo,60,2,2,1,acept,6000,200,77,6277
Campinas,160,4,2,2,acept,2800,207,36,3043
Sao Paulo,315,3,4,3,acept,5000,340,64,5404
Belo Horizonte,365,4,4,3,acept,8800,459,118,9377
Sao Paulo,45,2,1,1,acept,1100,0,14,1114
Rio de Janeiro,108,2,1,0,acept,2125,47,28,2200
Campinas,76,3,2,2,not acept,2200,120,28,2348
Belo Horizonte,140,4,3,2,acept,4000,284,54,4338
Belo Horizonte,30,1,1,0,not acept,750,57,10,817
Campinas,50,2,2,1,not acept,1400,63,18,1481
Sao Paulo,16,1,1,0,not acept,850,9,11,870
Porto Alegre,110,2,1,0,acept,2100,92,31,2223
Sao Paulo,270,4,4,4,acept,10800,800,163,11763
Sao Paulo,125,3,1,0,acept,2700,142,35,2877
Campinas,46,2,1,1,acept,970,42,13,1025
Sao Paulo,55,2,2,1,acept,2000,9,26,2035
Sao Paulo,82,3,2,2,acept,1500,59,20,1579
Rio de Janeiro,42,1,1,0,acept,1800,56,24,1880
Belo Horizonte,285,3,2,0,acept,6000,492,80,6572
Sao Paulo,76,2,2,1,not acept,1350,5,18,1373
Rio de Janeiro,338,4,2,2,acept,4300,190,66,4556
Sao Paulo,300,6,8,3,acept,10900,1917,164,12981
Sao Paulo,30,1,1,1,not acept,4600,0,59,4659
Sao Paulo,320,5,5,3,acept,8000,267,121,8388
Porto Alegre,80,2,1,0,acept,1900,50,28,1978
Sao Paulo,43,1,1,0,not acept,1080,57,14,1151
Sao Paulo,102,2,2,2,acept,3400,248,52,3700
Sao Paulo,47,2,1,1,acept,1000,0,13,1013
Rio de Janeiro,120,4,2,1,acept,12000,367,155,12522
Belo Horizonte,178,3,3,3,acept,7500,542,100,8142
Sao Paulo,27,1,1,0,not acept,1480,0,19,1499
Rio de Janeiro,174,4,2,1,acept,2400,500,31,2931
Sao Paulo,40,1,1,1,acept,1780,0,23,1803
Sao Paulo,64,1,2,1,acept,2600,0,33,2633
Belo Horizonte,252,3,4,1,acept,2500,165,34,2699
Porto Alegre,85,2,1,0,acept,870,56,13,939
Sao Paulo,101,3,2,2,acept,3200,319,41,3560
Porto Alegre,44,1,2,0,acept,1350,100,20,1470
Sao Paulo,200,3,2,1,acept,2380,161,31,2572
Belo Horizonte,55,2,2,1,acept,1000,67,14,1081
Sao Paulo,200,4,3,3,not acept,6400,0,82,6482
Sao Paulo,240,3,3,3,acept,3800,952,49,4801
Rio de Janeiro,90,3,2,1,acept,3170,225,41,3436
Sao Paulo,31,1,1,0,acept,1330,0,17,1347
Belo Horizonte,240,4,3,4,acept,7200,161,96,7457
Belo Horizonte,118,4,3,3,acept,2500,326,34,2860
Sao Paulo,350,4,5,2,acept,15000,667,226,15893
Sao Paulo,65,3,2,1,acept,2090,21,27,2138
Rio de Janeiro,145,3,2,1,acept,5800,500,75,6375
Sao Paulo,93,3,2,2,acept,3400,209,44,3653
Sao Paulo,98,1,2,2,not acept,8400,580,107,9087
Sao Paulo,174,3,1,2,acept,3600,284,55,3939
Sao Paulo,160,4,4,3,acept,4700,750,60,5510
Sao Paulo,200,4,5,3,acept,3700,600,47,4347
Sao Paulo,80,2,2,2,acept,1850,173,28,2051
Sao Paulo,50,2,1,1,acept,1490,0,19,1509
Belo Horizonte,115,3,3,3,acept,3100,272,42,3414
Sao Paulo,20,1,1,0,acept,1800,130,23,1953
Campinas,12732,3,2,0,acept,1600,96,21,1717
Sao Paulo,38,1,1,0,acept,3000,38,39,3077
Porto Alegre,42,1,1,1,acept,1200,65,18,1283
Sao Paulo,380,2,4,0,acept,6800,2863,87,9750
Belo Horizonte,70,2,1,1,acept,1500,63,20,1583
Sao Paulo,37,1,1,1,not acept,1196,0,16,1212
Rio de Janeiro,31,1,1,0,acept,1350,67,18,1435
Sao Paulo,156,2,4,2,acept,10000,520,127,10647
Sao Paulo,100,3,3,2,not acept,4350,350,56,4756
Belo Horizonte,50,2,1,1,acept,750,0,10,760
Sao Paulo,116,2,2,2,not acept,8000,250,102,8352
Sao Paulo,25,1,1,0,acept,1200,25,19,1244
Belo Horizonte,260,4,5,0,not acept,13000,138,174,13312
Porto Alegre,102,2,1,0,acept,1600,103,24,1727
Sao Paulo,160,2,3,2,acept,4210,225,54,4489
Belo Horizonte,95,3,2,2,not acept,2200,173,30,2403
Sao Paulo,189,4,4,4,acept,12000,817,153,12970
Sao Paulo,22,1,1,1,not acept,1900,84,25,2009
Sao Paulo,400,4,3,3,acept,7000,900,106,8006
Belo Horizonte,280,4,4,5,acept,6500,384,87,6971
Porto Alegre,45,1,1,0,acept,950,42,14,1006
Sao Paulo,50,2,1,1,acept,1260,100,16,1376
Sao Paulo,61,3,2,0,acept,1500,96,20,1616
Rio de Janeiro,100,2,2,1,acept,1600,0,21,1621
Sao Paulo,78,2,2,1,acept,2750,0,35,2785
Rio de Janeiro,140,3,2,1,acept,5000,334,65,5399
Sao Paulo,220,3,4,2,acept,3900,750,50,4700
Belo Horizonte,105,3,2,2,not acept,1500,135,20,1655
Belo Horizonte,550,3,3,5,acept,7500,350,123,7973
Sao Paulo,250,4,6,4,not acept,14500,875,184,15559
Rio de Janeiro,30,1,1,0,acept,1550,58,20,1628
Belo Horizonte,90,2,3,2,acept,2100,196,28,2324
Sao Paulo,110,2,3,2,acept,2310,409,30,2749
Sao Paulo,65,2,2,2,acept,2000,0,26,2026
Sao Paulo,160,1,4,2,not acept,3500,10,45,3555
Sao Paulo,34,1,1,1,acept,3800,109,49,3958
Porto Alegre,65,2,1,1,acept,950,38,14,1002
Sao Paulo,355,4,5,5,not acept,15000,2977,191,18168
Belo Horizonte,100,2,1,0,acept,1200,1680,16,2896
Campinas,320,3,3,2,acept,8500,340,108,8948
Rio de Janeiro,42,1,1,0,acept,1900,84,25,2009
Sao Paulo,79,2,2,1,acept,2800,4,36,2840
Sao Paulo,130,2,2,2,acept,3000,284,39,3323
Sao Paulo,84,2,2,0,acept,6000,250,77,6327
Campinas,300,3,3,4,acept,3800,450,58,4308
Sao Paulo,74,2,1,1,acept,1700,0,22,1722
Sao Paulo,450,4,4,3,acept,11500,875,173,12548
Porto Alegre,27,1,1,0,acept,960,75,15,1050
Sao Paulo,84,3,2,2,not acept,2800,740,36,3576
Sao Paulo,93,3,3,0,not acept,5500,367,70,5937
Porto Alegre,58,2,2,2,acept,2550,0,38,2588
Campinas,130,3,2,0,acept,1400,10,22,1432
Sao Paulo,35,1,1,1,not acept,2600,317,33,2950
Sao Paulo,156,3,2,1,acept,5500,267,70,5837
Sao Paulo,250,4,3,3,acept,5000,334,76,5410
Belo Horizonte,109,3,2,2,acept,1800,130,24,1954
Campinas,40,1,2,1,acept,807,43,3,853
Belo Horizonte,75,3,2,1,acept,1280,109,18,1407
Sao Paulo,100,3,3,2,acept,6300,491,80,6871
Sao Paulo,60,2,1,1,acept,1210,75,16,1301
Campinas,110,3,3,2,acept,3200,88,49,3337
Belo Horizonte,63,3,1,1,acept,1000,65,14,1079
Sao Paulo,550,3,5,8,acept,10000,3825,151,13976
Sao Paulo,112,3,2,2,acept,2670,188,34,2892
Sao Paulo,115,3,2,1,not acept,10000,0,151,10151
Belo Horizonte,65,2,1,1,acept,1100,84,15,1199
Belo Horizonte,65,3,2,2,acept,913,90,13,1016
Rio de Janeiro,200,4,2,1,acept,4250,400,55,4705
Rio de Janeiro,46,2,1,1,acept,1800,230,24,2054
Sao Paulo,320,4,5,4,acept,7000,700,106,7806
Rio de Janeiro,140,3,2,0,acept,3200,300,42,3542
Porto Alegre,87,3,3,2,acept,4000,150,59,4209
Belo Horizonte,78,1,1,1,not acept,2300,128,31,2459
Sao Paulo,25,1,1,0,not acept,2000,130,26,2156
Sao Paulo,50,2,2,1,acept,2800,67,36,2903
Rio de Janeiro,40,1,1,0,not acept,1949,100,26,2075
Rio de Janeiro,30,1,1,1,acept,500,0,7,507
Belo Horizonte,65,3,1,1,acept,1100,0,15,1115
Porto Alegre,181,3,3,2,acept,2400,1300,43,3743
Belo Horizonte,503,5,5,4,acept,6000,407,99,6506
Sao Paulo,50,1,1,0,not acept,1200,0,19,1219
Rio de Janeiro,180,3,3,1,acept,6500,117,84,6701
Sao Paulo,180,3,3,2,acept,7200,900,92,8192
Porto Alegre,75,2,1,0,acept,1600,0,24,1624
Belo Horizonte,70,3,2,1,acept,950,70,13,1033
Porto Alegre,40,1,1,0,not acept,2000,0,30,2030
Sao Paulo,100,3,2,1,acept,1600,50,21,1671
Sao Paulo,22,1,1,1,acept,2200,55,28,2283
Sao Paulo,50,2,2,1,not acept,1200,124,16,1340
Sao Paulo,90,3,1,2,acept,4100,300,52,4452
Belo Horizonte,150,3,3,2,not acept,3400,265,56,3721
Sao Paulo,20,1,1,0,not acept,3142,67,40,3249
Sao Paulo,120,2,1,1,not acept,3500,100,53,3653
Rio de Janeiro,50,2,2,1,acept,1450,50,19,1519
Rio de Janeiro,93,2,2,1,acept,1200,64,16,1280
Sao Paulo,18,1,1,0,acept,1720,0,22,1742
Porto Alegre,30,1,1,0,not acept,1490,15,22,1527
Sao Paulo,80,2,1,1,acept,1600,135,21,1756
Porto Alegre,46,1,1,1,not acept,1500,46,22,1568
Rio de Janeiro,90,2,2,0,acept,1000,97,13,1110
Rio de Janeiro,75,2,2,0,acept,2400,150,31,2581
Belo Horizonte,136,4,3,3,acept,3900,434,52,4386
Campinas,30,1,1,0,not acept,1100,9,14,1123
Rio de Janeiro,58,2,2,1,acept,1190,105,16,1311
Sao Paulo,95,2,2,0,acept,1550,82,20,1652
Porto Alegre,39,1,1,0,acept,550,24,9,583
Belo Horizonte,170,4,3,3,acept,6000,881,80,6961
Campinas,59,2,1,1,acept,1000,20,13,1033
Belo Horizonte,46,1,1,1,not acept,2500,158,34,2692
Sao Paulo,124,3,1,0,not acept,1200,100,16,1316
Rio de Janeiro,160,4,3,2,acept,6200,375,80,6655
Belo Horizonte,85,3,1,1,not acept,1600,62,22,1684
Rio de Janeiro,80,2,1,1,acept,2499,117,33,2649
Campinas,50,1,1,1,not acept,1600,13,21,1634
Sao Paulo,110,3,3,3,acept,4500,355,58,4913
Belo Horizonte,62,2,1,1,acept,1050,84,14,1148
Sao Paulo,500,4,6,6,acept,5510,2084,83,7677
Sao Paulo,230,3,4,2,acept,5900,680,75,6655
Belo Horizonte,115,3,3,1,not acept,1750,172,24,1946
Belo Horizonte,285,4,4,2,acept,3000,200,50,3250
Sao Paulo,89,3,3,2,not acept,3800,150,49,3999
Sao Paulo,49,2,1,1,acept,985,0,13,998
Belo Horizonte,500,4,6,4,not acept,15000,434,246,15680
Sao Paulo,35,1,1,1,not acept,3486,124,45,3655
Porto Alegre,58,2,1,1,acept,1350,25,20,1395
Campinas,300,4,5,2,acept,6000,0,91,6091
Porto Alegre,58,1,1,0,acept,700,28,11,739
Sao Paulo,800,5,7,6,acept,15000,2051,226,17277
Sao Paulo,60,2,1,1,acept,3300,67,42,3409
Sao Paulo,200,4,4,2,acept,5525,167,84,5776
Campinas,420,4,5,4,acept,7225,584,109,7918
Campinas,165,3,2,0,acept,3000,129,46,3175
Belo Horizonte,260,4,3,4,not acept,4500,480,74,5054
Sao Paulo,55,2,1,0,acept,1600,50,25,1675
Rio de Janeiro,55,1,1,0,acept,800,0,11,811
Sao Paulo,47,2,1,0,acept,1600,0,21,1621
Sao Paulo,38,1,1,0,acept,1650,0,21,1671
Rio de Janeiro,60,2,1,0,acept,1800,72,28,1900
Belo Horizonte,90,3,2,1,acept,1800,183,24,2007
Belo Horizonte,70,2,1,2,acept,1600,100,22,1722
Rio de Janeiro,41,1,1,1,not acept,3200,355,24,3579
Sao Paulo,35,1,1,1,not acept,3486,124,45,3655
Sao Paulo,70,2,1,1,acept,3100,108,40,3248
Campinas,43,1,1,1,acept,900,45,12,957
Rio de Janeiro,80,1,1,0,acept,4000,150,52,4202
Belo Horizonte,251,3,3,4,not acept,12000,1463,160,13623
Sao Paulo,185,4,5,4,acept,7100,1081,90,8271
Sao Paulo,520,3,4,2,acept,9000,1500,136,10636
Sao Paulo,30,1,1,0,acept,1150,50,15,1215
Sao Paulo,387,3,5,3,acept,7000,1334,89,8423
Rio de Janeiro,65,2,2,1,acept,1820,49,24,1893
Sao Paulo,155,3,3,2,acept,2650,233,40,2923
Porto Alegre,90,2,1,0,acept,1380,21,21,1422
Porto Alegre,61,2,1,2,not acept,2200,1,33,2234
Sao Paulo,60,2,1,0,acept,1100,56,14,1170
Sao Paulo,250,4,4,4,acept,3600,0,46,3646
Belo Horizonte,57,2,1,1,not acept,800,0,11,811
Sao Paulo,36,1,1,1,acept,2150,85,28,2263
Campinas,231,3,5,4,acept,12000,642,153,12795
Sao Paulo,67,3,1,1,acept,2900,150,37,3087
Sao Paulo,120,1,2,2,acept,4200,750,54,5004
Sao Paulo,215,3,4,2,not acept,7000,450,89,7539
Campinas,100,4,3,1,acept,2240,17,29,2286
Rio de Janeiro,50,2,1,1,acept,1150,9,15,1174
Porto Alegre,40,1,1,1,acept,1200,68,18,1286
Sao Paulo,20,1,1,0,acept,1800,130,23,1953
Sao Paulo,96,2,2,2,not acept,4000,273,51,4324
Porto Alegre,42,1,1,0,acept,985,49,15,1049
Porto Alegre,37,1,1,0,acept,1600,67,24,1691
Porto Alegre,110,2,2,1,acept,1453,20,22,1495
Sao Paulo,25,1,1,0,acept,1200,25,19,1244
Sao Paulo,96,2,2,2,acept,1600,400,21,2021
Sao Paulo,98,3,2,0,acept,1580,61,21,1662
Sao Paulo,70,2,1,0,not acept,1050,116,14,1180
Rio de Janeiro,127,1,2,1,not acept,6300,440,82,6822
Sao Paulo,138,3,3,2,acept,3000,100,39,3139
Rio de Janeiro,79,2,2,1,acept,1664,60,22,1746
Sao Paulo,45,1,1,0,not acept,1030,0,16,1046
Sao Paulo,35,1,1,0,not acept,1100,84,17,1201
Sao Paulo,180,3,4,3,acept,9000,1125,115,10240
Campinas,220,3,5,3,not acept,7900,417,101,8418
Porto Alegre,72,2,2,2,acept,2100,56,31,2187
Rio de Janeiro,150,3,3,0,acept,6000,467,78,6545
Sao Paulo,40,1,1,1,acept,1300,68,20,1388
Sao Paulo,45,2,1,1,not acept,1756,0,23,1779
Belo Horizonte,100,3,3,1,acept,1400,0,19,1419
Sao Paulo,140,3,2,2,acept,3700,167,47,3914
Porto Alegre,313,3,3,4,acept,4500,150,66,4716
Sao Paulo,25,1,1,0,not acept,2600,67,33,2700
Rio de Janeiro,300,5,4,5,acept,4080,234,63,4377
Porto Alegre,28,1,1,0,acept,500,25,8,533
Sao Paulo,249,4,4,3,acept,6800,0,103,6903
Porto Alegre,112,4,2,1,acept,1880,75,28,1983
Porto Alegre,50,2,1,1,acept,900,33,14,947
Sao Paulo,80,2,2,2,acept,3000,39,39,3078
Belo Horizonte,117,2,1,0,acept,2000,191,33,2224
Porto Alegre,85,2,2,1,not acept,2800,100,41,2941
Sao Paulo,45,1,1,0,acept,1275,0,17,1292
Sao Paulo,76,3,2,2,acept,3400,201,44,3645
Rio de Janeiro,30,1,1,0,not acept,505,85,7,597
Porto Alegre,20,1,1,1,acept,950,75,14,1039
Sao Paulo,250,2,2,8,acept,4500,459,68,5027
Sao Paulo,60,2,2,1,acept,2514,0,32,2546
Porto Alegre,65,2,2,1,acept,1300,142,19,1461
Campinas,55,1,1,1,not acept,2230,0,29,2259
Sao Paulo,150,2,1,2,acept,5500,0,83,5583
Sao Paulo,55,2,1,1,not acept,1700,111,22,1833
Sao Paulo,40,1,1,0,not acept,650,0,10,660
Rio de Janeiro,27,1,1,0,acept,2400,25,31,2456
Porto Alegre,99,3,3,1,not acept,2500,167,37,2704
Rio de Janeiro,100,3,2,1,acept,4190,181,54,4425
Sao Paulo,425,3,4,4,not acept,11000,3084,140,14224
Sao Paulo,44,2,1,1,acept,1340,0,17,1357
Sao Paulo,76,1,1,1,not acept,1400,17,22,1439
Sao Paulo,100,3,2,1,acept,6650,200,85,6935
Belo Horizonte,380,4,5,4,acept,8500,857,140,9497
Sao Paulo,292,4,3,3,acept,11480,709,146,12335
Sao Paulo,350,5,3,6,acept,5670,1084,86,6840
Sao Paulo,420,4,5,0,acept,6460,1480,98,8038
Rio de Janeiro,100,2,1,1,acept,5000,0,65,5065
Belo Horizonte,80,2,1,0,acept,1150,75,16,1241
Porto Alegre,61,2,1,1,acept,1700,50,25,1775
Campinas,48,2,1,0,acept,700,18,9,727
Campinas,100,3,2,8,acept,2000,82,31,2113
Sao Paulo,50,2,1,1,acept,2895,133,37,3065
Sao Paulo,141,4,3,1,not acept,4320,550,55,4925
Sao Paulo,25,1,1,0,not acept,620,15,8,643
Sao Paulo,60,1,1,0,acept,800,0,13,813
Porto Alegre,75,2,1,0,acept,880,38,13,931
Sao Paulo,45,2,1,1,acept,1598,0,21,1619
Porto Alegre,74,2,2,0,acept,2700,50,40,2790
Sao Paulo,38,1,1,0,not acept,950,0,13,963
Porto Alegre,47,1,1,1,not acept,2200,0,33,2233
Sao Paulo,63,2,3,1,acept,2114,150,27,2291
Porto Alegre,33,1,1,0,acept,900,90,12,1002
Sao Paulo,40,1,1,0,not acept,3400,74,44,3518
Belo Horizonte,180,3,3,2,acept,2800,150,38,2988
Sao Paulo,56,2,2,1,not acept,1510,131,20,1661
Sao Paulo,250,4,2,8,acept,13040,500,197,13737
Belo Horizonte,400,4,3,3,not acept,7000,613,115,7728
Belo Horizonte,120,4,3,2,acept,3250,0,44,3294
Rio de Janeiro,200,4,3,1,not acept,6800,534,88,7422
Sao Paulo,200,3,3,2,acept,7225,642,92,7959
Sao Paulo,63,2,2,1,not acept,2500,0,32,2532
Sao Paulo,54,1,1,1,acept,3850,209,49,4108
Sao Paulo,80,3,2,3,acept,1615,160,21,1796
Rio de Janeiro,110,3,1,1,acept,3000,30,39,3069
Sao Paulo,88,2,3,2,acept,6835,0,44,6879
Belo Horizonte,90,3,2,1,not acept,1890,0,31,1921
Sao Paulo,291,4,3,2,acept,5400,434,69,5903
Porto Alegre,48,2,1,1,acept,1400,30,21,1451
Campinas,70,2,1,2,acept,2100,55,27,2182
Sao Paulo,193,4,4,4,not acept,9000,917,115,10032
Sao Paulo,170,4,4,3,acept,1440,834,19,2293
Sao Paulo,30,1,1,0,not acept,1200,0,19,1219
Sao Paulo,86,1,2,1,acept,6500,375,83,6958
Campinas,50,1,1,1,acept,700,26,9,735
Rio de Janeiro,40,1,1,0,acept,1100,0,15,1115
Sao Paulo,72,2,2,1,acept,2500,234,32,2766
Sao Paulo,47,1,1,0,not acept,1000,76,13,1089
Rio de Janeiro,60,2,1,1,acept,1200,55,16,1271
Rio de Janeiro,55,1,1,0,not acept,2410,87,32,2529
Belo Horizonte,462,4,6,0,acept,7600,884,102,8586
Belo Horizonte,280,4,4,3,acept,6500,458,87,7045
Sao Paulo,230,6,4,8,acept,10000,0,151,10151
Belo Horizonte,100,3,2,3,acept,2300,233,31,2564
Sao Paulo,69,2,1,1,acept,1400,98,18,1516
Sao Paulo,50,2,1,1,not acept,3400,200,44,3644
Sao Paulo,71,3,2,2,acept,2190,92,28,2310
Sao Paulo,163,3,4,3,acept,3000,822,39,3861
Rio de Janeiro,450,4,5,3,not acept,7500,825,97,8422
Porto Alegre,29,1,1,0,not acept,1042,24,8,1074
Rio de Janeiro,70,2,2,0,acept,2140,125,28,2293
Sao Paulo,40,1,1,0,not acept,850,41,13,904
Porto Alegre,22,1,1,0,acept,800,20,12,832
Sao Paulo,299,4,5,4,acept,6300,1096,80,7476
Sao Paulo,73,3,2,2,acept,2520,192,32,2744
Sao Paulo,440,6,7,0,acept,5950,2320,90,8360
Sao Paulo,330,4,5,5,acept,3911,2176,50,6137
Porto Alegre,600,3,4,4,acept,3300,186,59,3545
Rio de Janeiro,195,3,3,0,acept,10000,375,129,10504
Sao Paulo,62,3,2,1,acept,2000,125,26,2151
Sao Paulo,230,3,6,5,acept,11050,1500,141,12691
Sao Paulo,64,2,1,1,acept,1090,25,14,1129
Campinas,60,2,1,1,acept,1400,26,18,1444
Rio de Janeiro,76,2,2,2,not acept,3300,226,43,3569
Sao Paulo,230,3,3,1,acept,5800,589,74,6463
Sao Paulo,200,2,2,1,acept,2300,92,35,2427
Rio de Janeiro,25,1,1,0,not acept,1800,40,24,1864
Sao Paulo,90,2,1,1,acept,3000,50,39,3089
Belo Horizonte,100,3,3,2,acept,3000,305,40,3345
Sao Paulo,382,4,4,4,acept,3200,710,41,3951
Sao Paulo,68,3,1,1,acept,1450,0,19,1469
Belo Horizonte,120,4,2,0,acept,1800,60,30,1890
Sao Paulo,85,2,1,1,acept,1600,0,21,1621
Sao Paulo,108,3,2,2,not acept,3000,350,39,3389
Rio de Janeiro,100,3,2,0,not acept,2900,259,38,3197
Sao Paulo,42,1,1,0,acept,1700,0,22,1722
Porto Alegre,336,3,4,3,acept,12500,500,183,13183
Belo Horizonte,200,4,3,2,acept,13000,236,214,13450
Belo Horizonte,50,2,1,0,not acept,750,59,13,822
Sao Paulo,30,1,1,0,acept,1550,125,20,1695
Sao Paulo,35,1,1,1,acept,1950,84,25,2059
Rio de Janeiro,100,2,2,0,acept,2956,310,39,3305
Sao Paulo,112,1,2,2,acept,8389,0,107,8496
Sao Paulo,40,1,1,1,acept,2156,123,28,2307
Sao Paulo,58,2,1,1,acept,1900,100,25,2025
Sao Paulo,250,3,4,4,acept,4000,1100,51,5151
Porto Alegre,62,2,1,0,not acept,1250,40,19,1309
Sao Paulo,65,2,2,0,acept,2200,61,28,2289
Belo Horizonte,120,4,3,2,acept,3250,0,44,3294
Sao Paulo,22,1,1,0,not acept,1800,62,23,1885
Rio de Janeiro,35,1,1,0,not acept,1100,21,15,1136
Sao Paulo,102,3,2,1,acept,3200,80,41,3321
Sao Paulo,500,4,5,6,not acept,7225,1209,109,8543
Sao Paulo,20,1,1,0,acept,1800,130,23,1953
Sao Paulo,79,3,2,2,acept,2600,314,33,2947
Sao Paulo,23,1,1,0,acept,2150,42,28,2220
Sao Paulo,360,3,5,3,acept,8500,1500,108,10108
Campinas,470,4,4,0,acept,3700,723,56,4479
Rio de Janeiro,70,2,1,1,acept,1300,80,17,1397
Sao Paulo,450,5,5,6,acept,9500,1345,143,10988
Sao Paulo,73,1,2,2,acept,3500,0,45,3545
Sao Paulo,204,4,5,3,not acept,8000,417,102,8519
Sao Paulo,400,9,4,4,acept,12000,500,181,12681
Belo Horizonte,115,2,2,1,not acept,1400,118,19,1537
Sao Paulo,111,3,4,2,not acept,4000,0,51,4051
Campinas,120,4,3,8,acept,4500,500,68,5068
Sao Paulo,65,2,2,1,acept,2300,63,30,2393
Sao Paulo,39,1,1,1,acept,2500,301,32,2833
Porto Alegre,70,2,1,0,acept,1400,59,21,1480
Sao Paulo,35,1,1,0,acept,1500,0,20,1520
Sao Paulo,60,2,3,2,not acept,1100,19,14,1133
Campinas,50,2,1,1,acept,680,50,9,739
Sao Paulo,221,3,5,4,acept,10850,643,138,11631
Sao Paulo,130,2,2,1,acept,4300,100,55,4455
Sao Paulo,310,4,3,3,acept,8000,0,102,8102
Sao Paulo,33,1,1,0,acept,1500,0,20,1520
Belo Horizonte,45,1,1,0,not acept,800,50,14,864
Campinas,45,1,1,1,not acept,850,140,11,1001
Sao Paulo,105,2,1,2,acept,2360,155,30,2545
Belo Horizonte,280,4,2,3,not acept,3500,471,47,4018
Sao Paulo,50,1,1,1,not acept,2500,342,32,2874
Rio de Janeiro,30,1,1,0,acept,1250,0,17,1267
Sao Paulo,50,2,1,1,acept,1450,0,19,1469
Porto Alegre,70,2,1,1,acept,1900,378,28,2306
Belo Horizonte,30,1,1,0,not acept,1500,0,20,1520
Sao Paulo,132,4,4,3,acept,2400,442,31,2873
Rio de Janeiro,250,2,3,2,acept,3500,349,54,3903
Sao Paulo,147,4,2,2,acept,2100,128,32,2260
Belo Horizonte,159,3,3,3,acept,7100,150,95,7345
Sao Paulo,230,3,3,4,acept,3200,750,41,3991
Campinas,75,3,2,2,acept,1450,75,19,1544
Rio de Janeiro,250,7,3,0,acept,15000,0,229,15229
Sao Paulo,620,4,5,5,acept,15000,5160,191,20351
Sao Paulo,118,3,2,4,acept,2250,334,29,2613
Porto Alegre,440,3,3,3,not acept,10500,84,154,10738
Porto Alegre,55,2,1,0,not acept,1195,210,18,1423
Sao Paulo,482,4,4,4,acept,9180,1250,138,10568
Sao Paulo,550,5,6,0,acept,15000,1435,226,16661
Sao Paulo,55,2,1,1,acept,3000,123,39,3162
Rio de Janeiro,140,4,2,1,acept,3500,167,46,3713
Rio de Janeiro,28,1,1,0,acept,1850,59,24,1933
Porto Alegre,103,3,1,3,acept,2200,670,40,2910
Sao Paulo,53,2,1,1,acept,1270,31,17,1318
Sao Paulo,300,4,7,4,acept,9800,1405,125,11330
Sao Paulo,190,4,4,3,acept,7110,589,91,7790
Sao Paulo,99,2,1,1,acept,3650,230,55,3935
Sao Paulo,84,3,2,2,acept,1600,258,21,1879
Sao Paulo,161,4,3,3,acept,3600,300,46,3946
Sao Paulo,53,2,1,1,acept,950,12,13,975
Rio de Janeiro,16,1,1,0,acept,1390,0,18,1408
Sao Paulo,36,1,1,1,acept,3000,84,39,3123
Rio de Janeiro,50,1,1,1,acept,2300,132,30,2462
Porto Alegre,70,3,1,1,not acept,1800,0,27,1827
Sao Paulo,105,3,2,2,acept,1000,290,13,1303
Sao Paulo,30,1,1,0,not acept,1350,39,18,1407
Sao Paulo,216,4,4,3,not acept,8000,1125,102,9227
Belo Horizonte,50,3,1,1,acept,1250,0,17,1267
Sao Paulo,250,3,4,2,not acept,7000,42,89,7131
Sao Paulo,230,3,3,2,acept,2460,330,37,2827
Sao Paulo,157,3,2,0,acept,4500,347,58,4905
Porto Alegre,150,3,3,0,not acept,4740,290,70,5100
Sao Paulo,110,3,2,0,acept,2200,6,28,2234
Sao Paulo,193,4,3,3,acept,13100,898,166,14164
Sao Paulo,114,2,2,2,acept,4998,0,64,5062
Porto Alegre,92,2,2,1,not acept,1900,120,28,2048
Sao Paulo,75,3,3,0,acept,2660,10,34,2704
Sao Paulo,270,2,2,3,acept,1429,0,22,1451
Campinas,80,2,2,1,acept,2000,34,26,2060
Porto Alegre,90,4,2,1,not acept,2142,212,32,2386
Rio de Janeiro,130,3,3,1,acept,2500,128,33,2661
Sao Paulo,40,1,1,0,not acept,860,59,13,932
Sao Paulo,60,2,2,1,acept,2127,23,27,2177
Porto Alegre,64,1,1,1,acept,1500,400,22,1922
Rio de Janeiro,80,2,1,1,acept,8000,325,104,8429
Sao Paulo,45,1,1,1,not acept,800,0,11,811
Sao Paulo,60,2,2,1,not acept,4000,0,51,4051
Sao Paulo,277,3,2,1,acept,7800,601,99,8500
Sao Paulo,57,1,1,0,acept,6000,17,77,6094
Sao Paulo,23,1,1,1,acept,2300,59,30,2389
Sao Paulo,73,3,2,2,acept,2500,236,32,2768
Sao Paulo,36,1,1,0,acept,2150,40,28,2218
Belo Horizonte,88,2,3,2,not acept,1450,110,20,1580
Sao Paulo,197,4,3,1,acept,2800,514,36,3350
Belo Horizonte,175,3,2,2,acept,2400,350,32,2782
Sao Paulo,400,4,4,4,acept,9000,1125,115,10240
Sao Paulo,260,3,4,3,acept,5000,393,47,5440
Rio de Janeiro,80,2,1,0,not acept,1100,0,15,1115
Sao Paulo,190,3,3,4,acept,4500,0,68,4568
Rio de Janeiro,65,1,1,0,acept,1800,30,24,1854
Sao Paulo,50,1,1,0,not acept,1250,34,19,1303
Sao Paulo,136,3,3,2,not acept,8900,482,113,9495
Sao Paulo,96,3,3,2,acept,1710,90,22,1822
Belo Horizonte,155,4,1,2,acept,3350,249,45,3644
Sao Paulo,384,5,5,3,acept,8000,1240,102,9342
Rio de Janeiro,144,3,2,0,acept,5500,530,71,6101
Sao Paulo,135,3,3,2,not acept,13800,375,175,14350
Sao Paulo,25,1,1,0,not acept,1000,84,16,1100
Rio de Janeiro,55,2,1,0,acept,2200,99,29,2328
Sao Paulo,250,3,3,2,not acept,7000,417,106,7523
Sao Paulo,66,2,1,1,not acept,2140,0,28,2168
Belo Horizonte,240,4,4,6,not acept,15000,1085,200,16285
Sao Paulo,176,4,5,0,acept,9500,792,121,10413
Rio de Janeiro,88,3,2,1,acept,3500,240,46,3786
Rio de Janeiro,70,2,1,1,acept,2600,30,34,2664
Sao Paulo,127,2,2,3,acept,2600,133,40,2773
Sao Paulo,201,3,5,3,not acept,10000,795,127,10922
Campinas,60,2,1,1,not acept,3250,156,42,3448
Sao Paulo,42,1,1,1,not acept,2800,209,36,3045
Porto Alegre,65,2,1,1,acept,1400,22,21,1443
Belo Horizonte,20,1,1,1,acept,1100,0,15,1115
Rio de Janeiro,118,3,2,0,not acept,2550,172,33,2755
Sao Paulo,98,3,5,1,acept,5510,0,70,5580
Sao Paulo,505,3,5,0,not acept,8600,2434,109,11143
Rio de Janeiro,110,3,1,2,acept,5000,417,65,5482
Porto Alegre,75,2,2,1,acept,2100,68,31,2199
Sao Paulo,50,1,1,0,not acept,750,0,12,762
Porto Alegre,93,2,1,0,not acept,800,86,12,898
Sao Paulo,230,4,6,4,acept,3000,2658,39,5697
Belo Horizonte,300,4,3,3,acept,5000,535,67,5602
Belo Horizonte,80,3,2,2,acept,1450,140,20,1610
Sao Paulo,144,4,4,4,acept,4900,667,63,5630
Sao Paulo,299,3,3,3,acept,1942,316,25,2283
Sao Paulo,168,4,3,3,acept,13000,809,165,13974
Rio de Janeiro,120,3,2,0,acept,1450,308,19,1777
Sao Paulo,135,3,2,1,acept,2900,180,44,3124
Rio de Janeiro,39,1,1,0,acept,980,20,13,1013
Sao Paulo,211,2,2,2,acept,4500,752,68,5320
Porto Alegre,160,2,3,2,acept,5200,100,93,5393
Sao Paulo,60,2,1,1,acept,1150,120,15,1285
Campinas,45,1,1,1,not acept,1900,83,25,2008
Sao Paulo,120,3,3,2,acept,2900,375,44,3319
Campinas,136,4,5,3,acept,3579,218,46,3843
Sao Paulo,140,2,2,2,acept,3990,394,51,4435
Sao Paulo,380,4,5,4,acept,4080,1509,52,5641
Sao Paulo,62,2,1,1,acept,2200,59,28,2287
Sao Paulo,35,1,1,1,not acept,3290,124,42,3456
Sao Paulo,100,4,3,0,acept,4280,175,55,4510
Campinas,60,1,1,1,acept,1300,30,20,1350
Rio de Janeiro,95,2,1,0,acept,2000,55,31,2086
Sao Paulo,25,1,1,0,not acept,1200,35,16,1251
Belo Horizonte,255,3,2,4,not acept,2800,250,46,3096
Campinas,180,3,3,3,acept,7600,477,97,8174
Sao Paulo,59,2,1,1,acept,1510,0,20,1530
Sao Paulo,420,3,3,4,acept,12000,2936,153,15089
Sao Paulo,125,3,3,3,acept,5000,1165,64,6229
Sao Paulo,80,2,1,0,acept,1800,209,23,2032
Campinas,37,1,1,0,not acept,742,0,10,752
Sao Paulo,110,3,3,2,acept,2200,418,28,2646
Sao Paulo,150,4,2,2,acept,3100,267,47,3414
Rio de Janeiro,31,1,1,0,not acept,1750,50,23,1823
Belo Horizonte,100,3,2,1,acept,1500,120,20,1640
Sao Paulo,100,2,2,0,not acept,1710,175,22,1907
Rio de Janeiro,56,2,2,0,not acept,2500,84,33,2617
Belo Horizonte,75,3,1,1,not acept,1100,80,15,1195
Sao Paulo,166,2,1,5,acept,2200,200,34,2434
Porto Alegre,129,3,3,0,acept,3800,225,56,4081
Sao Paulo,80,3,1,0,acept,6000,0,91,6091
Sao Paulo,204,3,2,2,acept,7000,764,89,7853
Sao Paulo,303,3,3,4,acept,10250,2470,130,12850
Sao Paulo,221,4,4,4,not acept,12830,920,163,13913
Porto Alegre,75,3,1,0,acept,1080,22,16,1118
Campinas,44,1,1,0,acept,520,23,7,550
Sao Paulo,50,2,1,1,acept,1100,100,14,1214
Sao Paulo,95,3,3,2,not acept,3150,121,40,3311
Porto Alegre,75,2,1,0,acept,1020,150,15,1185
Sao Paulo,48,1,1,1,acept,2200,35,28,2263
Belo Horizonte,114,3,2,2,not acept,3500,308,47,3855
Campinas,75,2,2,2,acept,2000,148,26,2174
Sao Paulo,220,3,3,2,not acept,6300,468,80,6848
Sao Paulo,100,4,3,2,acept,2500,369,32,2901
Rio de Janeiro,380,3,4,3,not acept,15000,2500,194,17694
Rio de Janeiro,50,1,1,0,not acept,1850,35,24,1909
Belo Horizonte,50,2,1,0,not acept,1050,0,18,1068
Rio de Janeiro,80,2,1,1,acept,2400,129,31,2560
Belo Horizonte,45,1,1,1,not acept,3000,0,40,3040
Sao Paulo,250,3,3,2,acept,12750,1084,162,13996
Sao Paulo,44,1,1,1,not acept,3300,149,42,3491
Sao Paulo,50,2,1,1,acept,4500,125,58,4683
Sao Paulo,156,3,4,2,acept,2000,0,26,2026
Sao Paulo,42,1,1,1,acept,2326,160,9,2495
Campinas,570,4,6,5,acept,12000,817,181,12998
Campinas,67,2,1,0,acept,880,41,14,935
Sao Paulo,264,4,4,6,acept,6440,574,97,7111
Sao Paulo,350,3,4,4,acept,3100,2900,47,6047
Sao Paulo,54,2,2,1,acept,2800,192,36,3028
Rio de Janeiro,400,2,2,1,acept,2300,6,30,2336
Belo Horizonte,420,4,3,8,acept,6320,0,104,6424
Belo Horizonte,50,1,1,0,acept,750,30,10,790
Sao Paulo,93,2,1,1,acept,2150,76,28,2254
Sao Paulo,350,4,4,2,acept,10000,500,151,10651
Sao Paulo,135,3,3,2,acept,2690,361,35,3086
Sao Paulo,32,1,1,0,not acept,1290,33,17,1340
Rio de Janeiro,52,1,1,1,acept,2390,117,31,2538
Sao Paulo,250,3,4,2,acept,10000,584,127,10711
Sao Paulo,60,1,2,2,acept,3000,0,39,3039
Campinas,109,3,1,1,acept,1150,146,15,1311
Sao Paulo,200,3,3,1,acept,5800,365,74,6239
Sao Paulo,38,1,1,1,acept,2400,0,31,2431
Porto Alegre,30,1,1,1,not acept,1330,0,20,1350
Sao Paulo,215,3,4,4,acept,12000,1252,153,13405
Sao Paulo,340,4,6,4,acept,9600,2167,122,11889
Rio de Janeiro,30,1,1,0,acept,2900,100,38,3038
Sao Paulo,850,4,4,8,acept,12000,5834,181,18015
Sao Paulo,90,3,2,1,acept,1800,44,23,1867
Sao Paulo,180,3,4,4,acept,12000,818,153,12971
Rio de Janeiro,60,1,1,1,acept,2165,110,28,2303
Sao Paulo,50,2,1,1,acept,1850,167,24,2041
Sao Paulo,280,3,3,2,acept,3500,250,53,3803
Sao Paulo,48,1,1,1,acept,3300,110,42,3452
Sao Paulo,42,1,1,0,acept,1800,0,23,1823
Campinas,210,3,3,0,acept,3050,300,46,3396
Campinas,70,2,2,1,acept,1400,44,22,1466
Belo Horizonte,100,3,2,0,not acept,12000,236,197,12433
Sao Paulo,520,4,6,4,acept,15000,2250,226,17476
Sao Paulo,253,3,3,4,acept,4500,1125,58,5683
Belo Horizonte,60,1,1,0,acept,950,55,13,1018
Sao Paulo,210,3,2,3,acept,2860,0,43,2903
Sao Paulo,66,2,1,1,acept,1650,166,21,1837
Sao Paulo,190,3,3,4,acept,12500,780,159,13439
Sao Paulo,17,1,1,0,not acept,2200,50,28,2278
Rio de Janeiro,157,3,2,1,acept,4500,550,58,5108
Belo Horizonte,40,1,1,2,acept,1600,126,22,1748
Belo Horizonte,100,3,2,2,acept,1500,169,20,1689
Campinas,238,4,5,4,acept,5000,421,64,5485
Belo Horizonte,102,3,2,2,acept,1100,0,15,1115
Campinas,188,2,3,8,acept,2930,584,45,3559
Sao Paulo,50,1,1,0,not acept,750,0,12,762
Sao Paulo,250,3,3,2,acept,9500,500,121,10121
Rio de Janeiro,139,2,2,1,acept,1300,234,17,1551
Porto Alegre,125,3,2,2,acept,7700,292,113,8105
Sao Paulo,40,1,1,0,not acept,1200,100,19,1319
Sao Paulo,65,2,2,1,not acept,7500,165,96,7761
Campinas,68,3,2,2,acept,1500,55,20,1575
Sao Paulo,85,2,1,0,acept,3100,28,40,3168
Sao Paulo,200,2,5,2,not acept,15000,937,191,16128
Rio de Janeiro,94,3,1,1,acept,2600,122,34,2756
Porto Alegre,38,1,1,1,acept,2500,42,37,2579
Campinas,105,3,2,2,acept,2000,121,31,2152
Porto Alegre,67,1,1,0,acept,950,25,14,989
Sao Paulo,104,3,3,2,not acept,9000,254,115,9369
Sao Paulo,50,2,1,1,acept,1900,0,25,1925
Rio de Janeiro,145,3,3,0,acept,4500,285,58,4843
Sao Paulo,225,3,2,2,acept,2300,209,35,2544
Sao Paulo,20,1,1,0,acept,1800,130,23,1953
Sao Paulo,170,4,5,3,acept,5200,709,66,5975
Sao Paulo,30,1,1,1,not acept,1630,227,21,1878
Belo Horizonte,75,3,1,1,acept,1100,61,15,1176
Campinas,75,2,2,1,acept,1189,75,16,1280
Sao Paulo,250,4,4,3,acept,6970,1580,89,8639
Sao Paulo,120,3,2,0,acept,2500,84,38,2622
Rio de Janeiro,45,1,1,0,acept,1901,80,25,2006
Rio de Janeiro,225,4,4,3,not acept,7500,1095,97,8692
Sao Paulo,245,4,5,4,acept,7000,750,89,7839
Porto Alegre,50,1,1,0,acept,1350,0,20,1370
Sao Paulo,350,3,4,2,acept,7000,507,106,7613
Rio de Janeiro,117,3,4,1,acept,4870,464,63,5397
Belo Horizonte,80,1,2,0,acept,1100,68,15,1183
Sao Paulo,340,3,4,5,acept,9800,0,125,9925
Sao Paulo,60,2,1,0,acept,1000,0,13,1013
Sao Paulo,250,3,2,8,acept,5950,472,90,6512
Sao Paulo,45,1,1,0,not acept,1160,0,18,1178
Sao Paulo,57,2,1,1,acept,1100,3,14,1117
Sao Paulo,30,1,1,1,not acept,3500,123,45,3668
Campinas,70,2,2,1,acept,1500,95,20,1615
Sao Paulo,55,2,2,1,acept,1850,0,24,1874
Sao Paulo,35,1,1,0,not acept,1800,101,28,1929
Sao Paulo,75,3,2,2,acept,2150,150,28,2328
Sao Paulo,156,3,3,5,not acept,4000,0,34,4034
Belo Horizonte,90,2,1,1,acept,1500,0,20,1520
Rio de Janeiro,90,3,2,2,acept,2500,250,33,2783
Rio de Janeiro,200,3,2,2,acept,15000,750,194,15944
Sao Paulo,86,2,1,1,acept,2372,0,10,2382
Sao Paulo,60,1,1,1,acept,3500,150,45,3695
Porto Alegre,50,1,1,0,acept,990,10,15,1015
Sao Paulo,108,3,2,2,acept,5600,275,71,5946
Sao Paulo,48,1,1,1,acept,2630,0,34,2664
Sao Paulo,100,3,2,1,acept,6502,0,83,6585
Campinas,48,1,1,0,not acept,800,80,11,891
Porto Alegre,67,2,1,1,acept,1550,77,23,1650
Rio de Janeiro,120,3,3,0,not acept,9240,209,120,9569
Sao Paulo,250,4,4,3,acept,3824,0,58,3882
Sao Paulo,49,1,1,1,acept,1760,21,23,1804
Sao Paulo,140,1,2,2,not acept,4500,334,58,4892
Sao Paulo,105,2,1,2,acept,3120,0,40,3160
Porto Alegre,60,2,1,1,acept,920,30,14,964
Sao Paulo,300,4,2,4,acept,10040,875,128,11043
Sao Paulo,93,2,2,1,acept,2500,84,32,2616
Sao Paulo,72,2,2,1,acept,2330,0,30,2360
Campinas,60,2,1,1,acept,820,16,11,847
Sao Paulo,250,3,4,4,acept,4200,0,64,4264
Rio de Janeiro,160,4,3,1,acept,6300,667,82,7049
Sao Paulo,104,2,2,1,not acept,4000,10,51,4061
Porto Alegre,66,2,1,1,acept,1000,38,15,1053
Belo Horizonte,148,2,3,3,acept,15000,685,200,15885
Sao Paulo,1000,4,2,8,acept,15000,2334,226,17560
Campinas,120,4,2,1,acept,1500,0,23,1523
Porto Alegre,100,3,3,1,not acept,3500,84,52,3636
Rio de Janeiro,114,2,2,1,not acept,3600,350,47,3997
Sao Paulo,153,3,4,3,acept,6300,534,80,6914
Sao Paulo,164,3,4,2,acept,12500,915,159,13574
Sao Paulo,65,2,2,1,acept,2040,0,31,2071
Campinas,270,4,5,0,not acept,5500,357,83,5940
Sao Paulo,225,4,6,4,acept,4500,742,58,5300
Rio de Janeiro,124,4,2,1,acept,5900,395,77,6372
Sao Paulo,68,3,1,2,acept,882,20,12,914
Sao Paulo,96,3,3,2,acept,5100,296,65,5461
Sao Paulo,210,4,4,3,acept,4700,375,71,5146
Sao Paulo,750,4,5,6,acept,13000,1500,196,14696
Sao Paulo,70,2,2,2,not acept,2954,590,38,3582
Rio de Janeiro,15,1,1,0,acept,700,0,10,710
Sao Paulo,33,1,1,1,not acept,3300,0,42,3342
Belo Horizonte,311,4,3,3,not acept,9000,583,120,9703
Sao Paulo,160,3,2,1,acept,7700,470,98,8268
Sao Paulo,158,3,3,2,acept,3000,175,39,3214
Campinas,62,2,1,1,acept,980,48,13,1041
Belo Horizonte,105,3,2,1,not acept,1200,135,16,1351
Sao Paulo,250,3,4,2,acept,8000,500,102,8602
Porto Alegre,47,1,1,1,not acept,2200,0,33,2233
Sao Paulo,90,3,2,0,acept,2300,84,30,2414
Sao Paulo,295,4,4,4,acept,9500,1417,121,11038
Sao Paulo,133,4,3,0,acept,3550,309,45,3904
Sao Paulo,220,5,5,4,acept,8880,875,113,9868
Sao Paulo,70,2,1,1,acept,2400,162,31,2593
Belo Horizonte,101,3,2,2,acept,2400,20,32,2452
Belo Horizonte,320,3,2,5,acept,2900,200,39,3139
Belo Horizonte,802,6,6,8,acept,15000,1003,246,16249
Rio de Janeiro,28,1,1,0,not acept,2300,55,30,2385
Porto Alegre,35,1,1,0,acept,1170,92,18,1280
Sao Paulo,115,3,1,2,acept,4300,300,55,4655
Rio de Janeiro,70,2,2,1,acept,4200,250,55,4505
Rio de Janeiro,157,3,3,2,acept,3800,382,49,4231
Sao Paulo,40,1,1,0,not acept,750,0,12,762
Rio de Janeiro,205,2,2,0,acept,7000,132,91,7223
Belo Horizonte,75,3,2,1,acept,1600,119,22,1741
Sao Paulo,126,3,2,2,acept,3650,150,16,3816
Sao Paulo,19,1,1,0,not acept,1200,41,16,1257
Sao Paulo,130,3,2,2,acept,3500,584,45,4129
Sao Paulo,360,5,4,0,not acept,3000,2084,39,5123
Sao Paulo,102,2,1,0,acept,1700,17,22,1739
Sao Paulo,290,3,3,1,acept,2500,340,32,2872
Sao Paulo,47,2,1,1,not acept,1150,38,15,1203
Sao Paulo,130,2,1,1,acept,2200,180,28,2408
Porto Alegre,75,3,2,1,acept,1500,63,22,1585
Rio de Janeiro,84,2,1,0,acept,1700,85,22,1807
Sao Paulo,25,1,1,1,not acept,2200,45,28,2273
Sao Paulo,36,1,1,0,acept,2500,30,32,2562
Belo Horizonte,260,4,3,3,acept,3300,555,44,3899
Rio de Janeiro,140,4,3,1,acept,7500,466,97,8063
Sao Paulo,400,4,3,2,acept,5650,338,85,6073
Sao Paulo,47,1,1,0,acept,1490,66,19,1575
Rio de Janeiro,240,4,4,2,acept,12500,938,162,13600
Sao Paulo,800,4,2,6,acept,15000,1667,226,16893
Sao Paulo,160,3,4,2,acept,8500,60,108,8668
Rio de Janeiro,103,3,1,0,acept,3500,0,46,3546
Sao Paulo,55,2,2,1,not acept,1680,0,22,1702
Sao Paulo,300,4,4,5,acept,11000,1225,140,12365
Sao Paulo,67,1,1,1,acept,3120,350,40,3510
Sao Paulo,175,3,5,3,acept,7650,1308,97,9055
Rio de Janeiro,100,2,3,1,acept,3170,84,41,3295
Campinas,80,3,1,0,acept,1000,30,13,1043
Rio de Janeiro,60,2,1,1,acept,1300,0,17,1317
Rio de Janeiro,154,3,2,0,acept,12000,200,155,12355
Sao Paulo,120,3,3,3,acept,2500,321,32,2853
Campinas,160,2,1,2,acept,3950,125,60,4135
Belo Horizonte,105,3,2,2,acept,3700,350,50,4100
Sao Paulo,110,2,2,0,not acept,3500,34,53,3587
Rio de Janeiro,58,1,1,1,acept,1050,56,14,1120
Sao Paulo,60,3,1,0,acept,1700,80,22,1802
Rio de Janeiro,80,2,1,0,not acept,2900,34,38,2972
Porto Alegre,35,1,1,0,acept,1170,92,18,1280
Sao Paulo,22,1,1,0,not acept,900,40,12,952
Porto Alegre,93,3,1,0,not acept,2400,143,36,2579
Belo Horizonte,263,3,4,4,acept,13000,1437,174,14611
Sao Paulo,150,3,1,2,acept,3600,334,55,3989
Sao Paulo,20,1,1,0,acept,1800,130,23,1953
Sao Paulo,250,4,2,1,acept,3500,42,53,3595
Sao Paulo,510,4,6,4,acept,5000,3167,64,8231
Sao Paulo,57,2,2,2,acept,1950,2,25,1977
Campinas,58,2,1,1,acept,2400,60,31,2491
Belo Horizonte,200,3,3,1,acept,2100,94,35,2229
Sao Paulo,387,4,6,4,acept,6400,2792,82,9274
Rio de Janeiro,200,4,2,2,acept,4500,157,69,4726
Porto Alegre,52,2,1,1,not acept,900,0,14,914
Sao Paulo,275,3,3,1,acept,8850,0,113,8963
Rio de Janeiro,76,2,2,2,acept,2740,180,36,2956
Sao Paulo,70,1,2,6,acept,3290,417,50,3757
Porto Alegre,68,3,2,1,acept,2200,56,33,2289
Sao Paulo,108,2,2,1,acept,5500,380,70,5950
Porto Alegre,114,3,1,0,acept,1700,75,25,1800
Porto Alegre,90,2,2,1,acept,1900,84,28,2012
Rio de Janeiro,20,1,1,0,acept,500,63,7,570
Belo Horizonte,51,3,1,1,acept,1000,27,14,1041
Belo Horizonte,550,5,5,3,acept,14000,364,230,14594
Porto Alegre,36,1,1,1,acept,650,9,10,669
Sao Paulo,230,3,4,4,not acept,11500,1250,146,12896
Sao Paulo,35,1,1,1,acept,1500,101,23,1624
Porto Alegre,700,8,8,4,acept,12000,0,214,12214
Sao Paulo,140,3,2,1,acept,6000,109,77,6186
Porto Alegre,77,2,2,2,acept,2000,0,30,2030
Sao Paulo,75,2,1,1,acept,1500,100,20,1620
Porto Alegre,110,4,1,1,acept,2200,2500,33,4733
Rio de Janeiro,29,1,1,0,acept,1341,50,18,1409
Rio de Janeiro,84,3,1,1,acept,1500,0,20,1520
Sao Paulo,132,3,5,2,not acept,10990,291,140,11421
Rio de Janeiro,170,2,2,1,acept,4900,255,64,5219
Porto Alegre,26,1,1,0,acept,800,12,12,824
Campinas,73,3,1,1,acept,850,46,11,907
Belo Horizonte,114,2,2,1,acept,1600,1500,22,3122
Rio de Janeiro,68,2,2,1,acept,2000,211,26,2237
Campinas,82,1,1,1,acept,1200,82,16,1298
Belo Horizonte,30,1,1,0,not acept,1200,65,16,1281
Porto Alegre,69,2,2,1,acept,2100,75,31,2206
Sao Paulo,33,1,1,1,not acept,3413,0,12,3425
Sao Paulo,84,2,2,1,acept,5300,145,68,5513
Campinas,620,5,6,4,acept,4860,1200,62,6122
Sao Paulo,90,3,2,1,acept,3090,125,40,3255
Sao Paulo,284,4,5,5,acept,5500,200,83,5783
Campinas,268,3,4,4,acept,3500,509,53,4062
Sao Paulo,100,3,4,4,acept,3600,160,55,3815
Rio de Janeiro,24,1,1,1,acept,1420,359,19,1798
Sao Paulo,64,2,1,1,not acept,1817,84,24,1925
Sao Paulo,34,1,1,1,acept,2800,81,36,2917
Rio de Janeiro,86,2,1,0,acept,2400,205,31,2636
Sao Paulo,54,1,1,1,acept,7500,192,96,7788
Belo Horizonte,128,3,2,2,acept,1400,161,19,1580
Belo Horizonte,250,2,3,2,acept,3500,0,58,3558
Campinas,295,7,6,4,not acept,6200,334,94,6628
Rio de Janeiro,80,3,2,1,acept,2500,115,33,2648
Sao Paulo,500,3,3,5,acept,15000,1125,226,16351
Sao Paulo,120,1,2,0,acept,761,129,10,900
Campinas,136,3,2,1,acept,1274,87,17,1378
Rio de Janeiro,170,3,2,2,acept,2500,291,33,2824
Belo Horizonte,386,3,4,8,acept,6500,730,107,7337
Sao Paulo,19,1,1,0,not acept,1200,41,16,1257
Sao Paulo,550,4,6,4,acept,14000,1917,178,16095
Sao Paulo,384,3,5,3,acept,10000,1050,151,11201
Porto Alegre,48,1,1,0,acept,750,21,11,782
Sao Paulo,98,2,1,1,acept,3080,129,40,3249
Belo Horizonte,50,2,1,1,acept,1100,68,15,1183
Sao Paulo,53,2,2,1,not acept,2100,0,27,2127
Sao Paulo,32,1,1,0,acept,1990,0,26,2016
Sao Paulo,47,1,2,1,acept,3200,150,41,3391
Sao Paulo,65,2,1,1,acept,1440,0,19,1459
Sao Paulo,56,1,1,2,not acept,3958,242,51,4251
Rio de Janeiro,140,2,2,1,not acept,3950,500,51,4501
Sao Paulo,45,1,1,0,not acept,1100,0,17,1117
Rio de Janeiro,21,1,1,0,acept,1200,0,16,1216
Sao Paulo,70,2,2,0,acept,5500,315,70,5885
Sao Paulo,120,2,3,2,acept,11500,250,146,11896
Rio de Janeiro,90,2,2,0,acept,3700,350,48,4098
Porto Alegre,25,1,1,0,acept,2000,26,30,2056
Sao Paulo,198,4,2,0,acept,4000,500,61,4561
Rio de Janeiro,80,2,2,1,not acept,5000,84,65,5149
Sao Paulo,40,1,1,1,not acept,2800,100,36,2936
Belo Horizonte,53,2,1,1,acept,1000,74,14,1088
Rio de Janeiro,75,2,2,1,acept,2300,223,30,2553
Rio de Janeiro,60,2,1,0,acept,1300,100,17,1417
Sao Paulo,142,3,2,2,acept,5440,584,69,6093
Rio de Janeiro,160,3,2,2,acept,7609,689,99,8397
Rio de Janeiro,26,1,1,0,acept,1600,61,21,1682
Sao Paulo,81,1,1,1,acept,1150,67,16,1233
Rio de Janeiro,50,1,1,0,acept,1900,100,25,2025
Belo Horizonte,62,2,1,1,acept,1050,84,14,1148
Belo Horizonte,55,1,1,0,not acept,1020,21,17,1058
Sao Paulo,298,4,6,5,acept,8450,750,128,9328
Campinas,55,2,1,1,acept,720,0,10,730
Rio de Janeiro,82,2,1,1,acept,1500,40,20,1560
Sao Paulo,40,1,1,1,not acept,2200,223,28,2451
Belo Horizonte,106,3,2,2,acept,2400,255,32,2687
Sao Paulo,335,4,5,5,acept,4913,1667,63,6643
Sao Paulo,60,2,2,1,acept,3400,100,44,3544
Sao Paulo,128,3,2,1,acept,3297,950,42,4289
Sao Paulo,250,3,2,4,acept,6000,875,91,6966
Sao Paulo,500,4,4,5,acept,9240,934,139,10313
Sao Paulo,120,3,3,2,acept,2750,125,42,2917
Sao Paulo,300,4,4,4,acept,6500,1420,83,8003
Rio de Janeiro,33,1,1,0,not acept,2110,0,28,2138
Sao Paulo,177,3,3,4,acept,4000,330,61,4391
Rio de Janeiro,126,3,2,1,acept,2350,133,31,2514
Sao Paulo,287,4,5,4,acept,3800,1744,49,5593
Sao Paulo,250,3,4,4,acept,8000,242,121,8363
Belo Horizonte,200,3,3,3,acept,4700,110,78,4888
Belo Horizonte,235,4,2,4,acept,4700,480,78,5258
Sao Paulo,247,3,4,5,acept,3400,234,44,3678
Sao Paulo,100,2,1,0,acept,1800,275,28,2103
Rio de Janeiro,230,3,2,1,acept,3260,84,50,3394
Sao Paulo,350,4,5,4,acept,11000,1042,166,12208
Sao Paulo,600,4,6,5,acept,6000,1167,77,7244
Sao Paulo,187,3,2,3,not acept,8400,584,127,9111
Rio de Janeiro,32,1,1,0,acept,3000,65,39,3104
Sao Paulo,40,1,1,0,acept,920,0,14,934
Sao Paulo,20,1,1,0,not acept,1000,10,13,1023
Sao Paulo,250,5,4,3,acept,3520,666,53,4239
Sao Paulo,210,4,4,4,not acept,5000,1250,64,6314
Campinas,46,1,1,1,acept,1950,0,25,1975
Sao Paulo,104,3,3,2,not acept,4000,350,51,4401
Sao Paulo,32,1,1,0,acept,1600,0,21,1621
Porto Alegre,115,3,2,2,acept,4500,166,66,4732
Sao Paulo,64,2,1,1,acept,2500,67,32,2599
Sao Paulo,280,4,6,5,acept,11500,1417,146,13063
Sao Paulo,80,2,1,1,acept,1500,0,20,1520
Sao Paulo,98,2,2,0,acept,4500,0,58,4558
Sao Paulo,70,2,2,1,acept,1800,71,23,1894
Campinas,40,1,1,1,acept,1300,236,17,1553
Campinas,200,3,2,3,acept,2000,153,31,2184
Campinas,600,4,6,3,acept,5500,819,83,6402
Sao Paulo,65,2,2,1,acept,4900,177,63,5140
Sao Paulo,320,4,5,3,acept,5000,409,76,5485
Sao Paulo,50,2,1,1,not acept,1150,50,15,1215
Porto Alegre,42,1,1,1,acept,2400,81,36,2517
Porto Alegre,71,2,1,0,acept,1600,34,24,1658
Sao Paulo,50,1,1,0,not acept,720,0,10,730
Belo Horizonte,160,3,3,2,acept,1700,0,23,1723
Porto Alegre,70,2,1,0,acept,1500,49,20,1569
Sao Paulo,187,3,4,3,acept,14000,1209,178,15387
Sao Paulo,186,4,5,4,acept,4100,1480,52,5632
Campinas,76,2,1,0,acept,700,100,9,809
Sao Paulo,50,2,1,1,not acept,1650,0,21,1671
Sao Paulo,260,4,5,4,acept,3300,1000,42,4342
Belo Horizonte,200,4,3,2,acept,15000,456,246,15702
Sao Paulo,35,1,1,0,acept,1850,0,24,1874
Sao Paulo,130,2,2,2,acept,6200,634,79,6913
Sao Paulo,20,1,1,0,acept,1800,130,23,1953
Porto Alegre,78,2,1,0,acept,1380,32,21,1433
Porto Alegre,50,2,1,0,not acept,750,0,11,761
Belo Horizonte,476,3,2,2,not acept,6100,202,101,6403
Sao Paulo,68,2,2,1,acept,3400,95,44,3539
Rio de Janeiro,110,2,2,1,acept,1400,216,19,1635
Sao Paulo,52,2,2,1,not acept,4000,300,51,4351
Sao Paulo,360,3,5,3,not acept,12500,125,159,12784
Campinas,70,3,2,1,acept,1300,55,17,1372
Belo Horizonte,500,4,4,6,acept,15000,1021,246,16267
Porto Alegre,96,3,1,0,acept,1000,42,15,1057
Sao Paulo,54,2,2,1,acept,2800,190,36,3026
Sao Paulo,41,1,1,1,acept,2387,17,31,2435
Rio de Janeiro,130,3,2,1,acept,2820,300,37,3157
Sao Paulo,87,2,2,1,acept,6675,167,85,6927
Sao Paulo,340,3,5,5,acept,6000,2000,91,8091
Rio de Janeiro,120,3,1,1,acept,2200,84,29,2313
Sao Paulo,90,2,1,2,acept,1480,225,23,1728
Sao Paulo,55,1,1,1,not acept,4950,225,63,5238
Belo Horizonte,160,3,2,2,not acept,3100,183,42,3325
Belo Horizonte,30,1,1,1,not acept,900,19,12,931
Belo Horizonte,103,3,2,1,not acept,1400,101,19,1520
Belo Horizonte,45,1,1,1,not acept,1500,91,20,1611
Sao Paulo,300,4,3,8,acept,4500,667,68,5235
Sao Paulo,72,2,2,2,acept,3700,184,47,3931
Porto Alegre,70,3,2,0,acept,2240,59,33,2332
Rio de Janeiro,133,1,2,1,acept,7000,367,91,7458
Sao Paulo,50,2,1,0,acept,1449,0,19,1468
Porto Alegre,69,3,1,1,acept,1100,75,17,1192
Porto Alegre,42,1,2,1,acept,2000,0,30,2030
Belo Horizonte,55,2,2,1,acept,1300,111,18,1429
Sao Paulo,117,3,2,2,acept,2400,124,31,2555
Sao Paulo,56,2,1,1,acept,2540,25,33,2598
Rio de Janeiro,50,1,1,1,acept,1000,0,13,1013
Sao Paulo,450,4,6,4,acept,10000,750,127,10877
Sao Paulo,62,3,1,1,acept,1260,59,16,1335
Sao Paulo,300,5,3,1,acept,10000,0,151,10151
Sao Paulo,141,3,3,1,acept,3800,372,49,4221
Porto Alegre,44,1,1,0,not acept,950,33,14,997
Rio de Janeiro,40,1,1,0,acept,2400,56,31,2487
Sao Paulo,230,2,1,8,acept,4500,720,68,5288
Sao Paulo,278,4,3,3,acept,10000,1514,127,11641
Sao Paulo,35,1,1,0,acept,1100,30,14,1144
Sao Paulo,130,3,2,2,acept,3400,299,52,3751
Sao Paulo,264,4,4,4,acept,14450,1792,184,16426
Belo Horizonte,93,3,2,0,acept,1750,99,24,1873
Sao Paulo,69,3,2,2,not acept,2200,84,28,2312
Rio de Janeiro,72,2,1,1,acept,1800,97,24,1921
Sao Paulo,66,2,1,1,not acept,2000,30,26,2056
Sao Paulo,44,1,1,1,acept,1400,142,18,1560
Belo Horizonte,227,3,4,1,not acept,2550,208,34,2792
Porto Alegre,100,2,1,1,acept,3400,172,50,3622
Sao Paulo,90,2,2,0,not acept,1800,375,23,2198
Sao Paulo,20,1,1,0,acept,1800,130,23,1953
Sao Paulo,70,1,1,1,not acept,2600,125,33,2758
Sao Paulo,135,2,3,3,acept,4200,459,54,4713
Sao Paulo,450,4,4,6,acept,9000,1917,136,11053
Sao Paulo,217,3,1,1,acept,3000,200,46,3246
Sao Paulo,300,4,5,4,not acept,3200,1875,41,5116
Sao Paulo,84,2,2,0,not acept,6300,454,80,6834
Porto Alegre,272,3,4,3,not acept,3990,187,71,4248
Sao Paulo,43,2,1,1,acept,1050,36,14,1100
Sao Paulo,400,4,4,0,acept,4500,1520,68,6088
Porto Alegre,48,1,1,0,acept,900,22,14,936
Porto Alegre,71,2,2,1,acept,892,59,14,965
Sao Paulo,100,6,7,5,acept,10660,2167,161,12988
Sao Paulo,225,4,2,2,acept,6500,642,83,7225
Sao Paulo,280,3,2,0,acept,3000,417,39,3456
Belo Horizonte,62,2,1,1,acept,1300,75,18,1393
Sao Paulo,330,5,3,6,acept,10500,1667,158,12325
Sao Paulo,90,3,2,1,acept,2000,5,26,2031
Sao Paulo,60,2,1,1,acept,1230,100,16,1346
Rio de Janeiro,67,3,2,0,not acept,2810,179,37,3026
Sao Paulo,287,4,5,3,acept,10000,955,151,11106
Sao Paulo,156,3,2,1,acept,6400,59,97,6556
Sao Paulo,273,4,4,2,not acept,9000,417,115,9532
Sao Paulo,320,3,3,4,acept,9000,1000,136,10136
Porto Alegre,330,3,4,2,acept,9000,375,160,9535
Sao Paulo,50,1,1,1,acept,900,59,14,973
Rio de Janeiro,15,1,1,0,not acept,908,0,12,920
Porto Alegre,100,3,1,1,acept,1240,69,19,1328
Sao Paulo,50,1,2,0,not acept,1510,0,23,1533
Campinas,60,2,1,1,acept,1000,0,13,1013
Rio de Janeiro,40,1,1,0,acept,1950,61,26,2037
Sao Paulo,312,3,6,3,acept,6300,1063,95,7458
Sao Paulo,86,2,1,1,acept,3007,84,39,3130
Rio de Janeiro,280,4,4,2,acept,9850,1255,127,11232
Belo Horizonte,260,4,4,6,acept,11900,12500,159,24559
Porto Alegre,68,2,1,1,acept,800,500,12,1312
Rio de Janeiro,58,2,2,1,acept,800,0,11,811
Campinas,68,2,1,0,acept,1650,14,25,1689
Sao Paulo,60,2,2,1,not acept,2600,184,33,2817
Campinas,47,1,1,0,acept,520,13,7,540
Campinas,87,3,2,1,acept,1173,90,15,1278
Sao Paulo,51,1,1,0,not acept,3250,37,42,3329
Sao Paulo,120,2,2,1,not acept,1450,21,19,1490
Campinas,52,2,1,1,acept,2280,0,29,2309
Rio de Janeiro,56,2,1,1,acept,960,17,13,990
Campinas,50,1,1,1,not acept,647,15,9,671
Sao Paulo,1000,4,5,7,acept,6800,4170,87,11057
Sao Paulo,36,1,1,1,not acept,3800,55,49,3904
Sao Paulo,260,2,4,4,acept,3455,1350,44,4849
Sao Paulo,55,2,1,1,acept,1700,35,22,1757
Sao Paulo,150,2,3,1,acept,1650,0,25,1675
Sao Paulo,146,3,3,3,not acept,7000,442,89,7531
Sao Paulo,320,3,4,3,acept,12000,2250,181,14431
Rio de Janeiro,70,2,1,1,acept,2200,93,29,2322
Campinas,69,3,2,2,acept,2000,142,26,2168
Campinas,100,4,2,1,acept,1600,125,25,1750
Sao Paulo,50,1,1,0,acept,2800,0,36,2836
Sao Paulo,33,1,1,0,acept,1650,0,21,1671
Sao Paulo,230,3,4,4,not acept,5500,200,83,5783
Sao Paulo,120,3,4,3,acept,5600,560,71,6231
Sao Paulo,55,1,2,0,not acept,1800,58,23,1881
Sao Paulo,20,1,1,0,acept,2800,68,36,2904
Campinas,55,1,1,1,not acept,1100,22,14,1136
Porto Alegre,46,1,1,1,acept,1100,100,17,1217
Sao Paulo,48,2,1,1,acept,1550,54,20,1624
Rio de Janeiro,95,2,1,0,acept,1670,200,22,1892
Sao Paulo,330,4,4,5,acept,10000,750,151,10901
Sao Paulo,50,2,1,1,acept,1300,34,17,1351
Campinas,79,2,2,2,acept,1000,78,13,1091
Campinas,60,2,1,1,not acept,830,0,13,843
Campinas,35,1,1,1,not acept,1000,0,16,1016
Sao Paulo,550,4,5,6,acept,10500,3942,134,14576
Sao Paulo,380,4,4,3,acept,8000,2180,102,10282
Sao Paulo,85,2,1,0,acept,2190,0,28,2218
Sao Paulo,50,2,1,0,acept,1900,0,25,1925
Sao Paulo,167,3,4,3,not acept,9000,613,115,9728
Porto Alegre,60,2,1,1,acept,1000,63,15,1078
Sao Paulo,147,3,4,2,acept,11000,334,140,11474
Sao Paulo,113,3,2,1,acept,3000,50,39,3089
Sao Paulo,136,3,4,3,acept,6100,433,78,6611
Belo Horizonte,25,1,1,1,not acept,500,38,7,545
Sao Paulo,50,2,1,1,acept,1300,0,17,1317
Sao Paulo,173,3,4,3,acept,1950,796,25,2771
Sao Paulo,272,3,5,4,acept,7000,0,89,7089
Sao Paulo,70,3,1,0,acept,1300,0,20,1320
Sao Paulo,57,1,2,0,acept,1400,0,18,1418
Belo Horizonte,350,5,5,2,acept,4000,298,54,4352
Rio de Janeiro,311,4,3,1,acept,15000,500,194,15694
Sao Paulo,71,2,2,2,not acept,3000,203,39,3242
Sao Paulo,90,2,1,1,acept,3000,50,39,3089
Belo Horizonte,500,3,1,2,acept,1280,109,21,1410
Sao Paulo,250,3,3,2,not acept,5380,234,69,5683
Sao Paulo,369,4,4,5,acept,15000,2917,191,18108
Sao Paulo,100,2,4,1,acept,3500,167,53,3720
Sao Paulo,240,4,4,4,acept,2890,1398,37,4325
Belo Horizonte,230,4,5,4,acept,9240,1262,124,10626
Sao Paulo,125,3,2,2,acept,3000,150,46,3196
Rio de Janeiro,70,2,1,1,not acept,1500,100,20,1620
Rio de Janeiro,40,2,2,0,acept,1000,55,13,1068
Sao Paulo,300,3,3,4,acept,7900,862,119,8881
Sao Paulo,79,2,2,1,not acept,1600,0,21,1621
Sao Paulo,46,1,1,1,acept,2400,0,31,2431
Rio de Janeiro,40,2,1,0,acept,1490,0,20,1510
Rio de Janeiro,50,1,1,0,acept,2308,138,30,2476
Campinas,235,4,4,3,acept,5500,541,70,6111
Sao Paulo,480,4,4,4,acept,15000,2084,191,17275
Sao Paulo,123,3,2,2,not acept,2450,250,32,2732
Sao Paulo,100,4,5,4,acept,2750,1417,35,4202
Belo Horizonte,400,6,5,5,acept,7500,417,123,8040
Rio de Janeiro,75,2,1,0,not acept,1850,123,24,1997
Sao Paulo,45,1,1,0,not acept,3400,81,44,3525
Rio de Janeiro,50,2,1,1,acept,1600,13,21,1634
Belo Horizonte,137,3,2,0,not acept,2000,0,27,2027
Porto Alegre,45,1,1,1,acept,1800,0,27,1827
Sao Paulo,60,2,1,1,acept,1800,0,23,1823
Sao Paulo,68,2,1,0,acept,1500,10,20,1530
Sao Paulo,66,2,2,1,not acept,1275,166,17,1458
Sao Paulo,52,2,1,1,not acept,2800,0,36,2836
Belo Horizonte,460,5,8,5,not acept,7320,0,121,7441
Sao Paulo,100,2,2,5,acept,6800,667,103,7570
Rio de Janeiro,52,1,1,0,acept,1200,65,16,1281
Campinas,42,1,1,0,not acept,950,34,13,997
Sao Paulo,127,3,2,2,acept,4000,505,51,4556
Porto Alegre,72,3,1,1,acept,1599,128,24,1751
Sao Paulo,82,3,2,2,acept,2230,145,29,2404
Sao Paulo,250,4,4,4,acept,8500,1167,108,9775
Porto Alegre,30,1,1,0,acept,1300,34,19,1353
Sao Paulo,600,4,5,3,acept,15000,334,226,15560
Porto Alegre,67,2,2,1,acept,1700,0,25,1725
Sao Paulo,67,1,2,2,acept,2230,271,29,2530
Porto Alegre,41,1,1,0,acept,2300,42,34,2376
Sao Paulo,300,4,3,1,not acept,8000,768,102,8870
Sao Paulo,50,2,2,0,not acept,1100,80,17,1197
Sao Paulo,75,3,2,1,not acept,1900,70,25,1995
Sao Paulo,50,1,1,0,not acept,1000,0,16,1016
Campinas,65,2,1,2,acept,800,136,11,947
Sao Paulo,129,3,4,2,acept,5155,562,66,5783
Sao Paulo,100,1,2,2,acept,5850,472,75,6397
Porto Alegre,116,4,3,1,acept,2700,64,40,2804
Sao Paulo,300,3,3,4,acept,9000,650,136,9786
Porto Alegre,45,1,1,1,not acept,3300,117,49,3466
Sao Paulo,43,1,1,0,acept,2000,9,26,2035
Sao Paulo,25,1,1,0,acept,1610,0,21,1631
Rio de Janeiro,410,4,5,2,acept,4000,584,61,4645
Sao Paulo,126,4,2,2,acept,3000,290,39,3329
Sao Paulo,350,5,4,3,acept,15000,1265,191,16456
Sao Paulo,25,1,1,0,not acept,1750,0,23,1773
Sao Paulo,48,2,1,1,not acept,1260,42,16,1318
Sao Paulo,300,3,2,2,acept,8820,163,133,9116
Rio de Janeiro,80,2,1,0,acept,2800,92,37,2929
Rio de Janeiro,163,3,3,0,acept,6400,400,83,6883
Sao Paulo,93,3,1,2,acept,1550,100,20,1670
Belo Horizonte,65,1,1,1,acept,3600,170,48,3818
Rio de Janeiro,47,1,1,0,acept,2000,102,26,2128
Sao Paulo,260,4,6,5,acept,6000,667,91,6758
Rio de Janeiro,80,3,1,0,acept,1510,15,20,1545
Porto Alegre,37,1,1,0,acept,2220,84,33,2337
Sao Paulo,126,3,2,2,acept,2400,334,31,2765
Belo Horizonte,220,4,4,3,not acept,2602,234,43,2879
Sao Paulo,160,3,5,2,acept,12000,334,181,12515
Campinas,100,3,2,1,acept,1700,0,22,1722
Sao Paulo,29,1,1,0,not acept,2900,50,37,2987
Sao Paulo,192,4,5,4,not acept,15000,90,191,15281
Sao Paulo,60,2,1,0,not acept,1300,0,17,1317
Belo Horizonte,40,2,1,0,not acept,1100,0,15,1115
Sao Paulo,339,4,5,4,acept,15000,1440,191,16631
Porto Alegre,115,3,3,1,acept,3250,200,48,3498
Rio de Janeiro,27,1,1,0,not acept,3000,61,39,3100
Porto Alegre,47,1,1,1,not acept,2200,0,33,2233
Sao Paulo,197,3,4,3,acept,6502,1167,83,7752
Sao Paulo,44,1,1,1,acept,3450,0,13,3463
Sao Paulo,226,4,5,6,acept,12000,917,153,13070
Sao Paulo,100,2,1,1,not acept,2900,234,37,3171
Belo Horizonte,300,4,3,4,acept,7500,942,123,8565
Porto Alegre,75,3,2,2,acept,1700,75,25,1800
Sao Paulo,160,2,1,3,acept,4000,0,61,4061
Campinas,53,1,1,0,acept,500,15,7,522
Rio de Janeiro,80,3,2,0,not acept,1105,47,15,1167
Porto Alegre,43,1,1,1,not acept,2200,42,33,2275
Sao Paulo,330,4,5,5,not acept,4500,0,58,4558
Sao Paulo,353,5,7,5,acept,10000,1917,127,12044
Sao Paulo,52,2,1,0,acept,1340,0,17,1357
Sao Paulo,185,3,3,2,acept,3280,100,42,3422
Rio de Janeiro,90,2,1,0,acept,960,90,13,1063
Campinas,48,1,1,0,acept,950,42,13,1005
Belo Horizonte,82,2,2,2,not acept,3800,303,51,4154
Sao Paulo,90,3,2,1,acept,1631,100,21,1752
Porto Alegre,42,1,1,1,not acept,800,280,12,1092
Campinas,290,4,3,1,acept,2600,192,33,2825
Sao Paulo,350,4,5,2,acept,5000,325,76,5401
Campinas,110,3,3,2,acept,3200,1056,49,4305
Campinas,50,1,1,1,acept,1200,52,16,1268
Sao Paulo,45,1,1,1,not acept,5520,0,70,5590
Belo Horizonte,70,3,2,1,acept,1400,103,19,1522
Sao Paulo,50,2,1,1,acept,1490,0,19,1509
Sao Paulo,45,1,1,1,not acept,2349,0,8,2357
Sao Paulo,180,2,2,0,not acept,2760,0,35,2795
Belo Horizonte,65,2,1,1,not acept,908,69,13,990
Sao Paulo,50,1,1,1,not acept,3900,105,50,4055
Sao Paulo,250,3,3,2,acept,9500,500,121,10121
Sao Paulo,90,2,1,0,acept,2000,280,26,2306
Sao Paulo,39,2,1,0,acept,1430,43,19,1492
Sao Paulo,180,3,2,1,acept,10000,180,127,10307
Rio de Janeiro,72,2,2,1,acept,1200,5,16,1221
Belo Horizonte,300,4,4,4,acept,7500,436,100,8036
Sao Paulo,45,1,1,1,not acept,3200,0,41,3241
Sao Paulo,84,1,2,0,acept,6000,250,77,6327
Sao Paulo,228,3,4,3,not acept,4800,513,61,5374
Rio de Janeiro,126,3,2,1,acept,3200,591,42,3833
Sao Paulo,260,3,3,3,acept,5000,842,64,5906
Campinas,230,3,3,3,acept,4500,534,58,5092
Sao Paulo,160,4,2,2,acept,2580,0,39,2619
Rio de Janeiro,90,2,2,1,acept,2600,426,34,3060
Sao Paulo,136,1,2,2,not acept,3000,417,39,3456
Campinas,109,4,3,2,not acept,2300,261,30,2591
Campinas,437,3,6,6,acept,13500,711,203,14414
Sao Paulo,400,4,4,3,acept,10000,2707,151,12858
Rio de Janeiro,90,3,3,1,acept,1950,167,26,2143
Belo Horizonte,120,4,3,2,acept,2800,242,38,3080
Porto Alegre,23,1,1,1,not acept,1100,34,17,1151
Porto Alegre,45,2,1,0,acept,1000,0,15,1015
Sao Paulo,51,1,1,1,acept,3500,200,45,3745
Sao Paulo,150,3,3,2,acept,2050,250,31,2331
Rio de Janeiro,200,4,3,4,acept,6800,849,88,7737
Sao Paulo,25,1,1,0,not acept,1184,53,18,1255
Sao Paulo,47,2,1,1,acept,2460,0,15,2475
Sao Paulo,340,3,4,4,not acept,12500,3084,159,15743
Campinas,252,3,3,4,acept,3300,259,50,3609
Sao Paulo,72,2,1,1,acept,1200,114,16,1330
Sao Paulo,159,3,2,1,not acept,3500,582,45,4127
Sao Paulo,270,3,4,3,acept,6800,417,103,7320
Rio de Janeiro,80,2,2,1,acept,1360,276,18,1654
Sao Paulo,700,6,6,6,acept,8500,1542,128,10170
Sao Paulo,96,2,2,2,acept,6500,250,83,6833
Sao Paulo,134,3,3,3,not acept,8000,380,102,8482
Belo Horizonte,60,2,1,1,acept,1550,103,21,1674
Sao Paulo,87,2,2,1,acept,3337,0,9,3346
Sao Paulo,45,1,1,0,not acept,1200,0,19,1219
Sao Paulo,350,4,2,8,acept,7000,450,106,7556
Porto Alegre,40,2,1,1,not acept,702,0,11,713
Rio de Janeiro,110,2,3,1,not acept,4600,92,60,4752
Sao Paulo,180,3,3,2,acept,2800,250,36,3086
Campinas,800,4,7,4,acept,15000,1898,226,17124
Sao Paulo,61,2,2,1,acept,4000,134,51,4185
Rio de Janeiro,60,2,1,0,acept,2350,135,31,2516
Rio de Janeiro,25,1,1,0,acept,550,0,8,558
Sao Paulo,84,3,1,1,acept,2300,3000,30,5330
Sao Paulo,84,3,3,2,acept,1600,258,21,1879
Sao Paulo,220,3,5,4,acept,6800,84,87,6971
Sao Paulo,300,5,5,3,acept,4700,334,71,5105
Sao Paulo,269,4,4,5,acept,14000,1834,178,16012
Rio de Janeiro,98,3,2,0,acept,3500,182,46,3728
Sao Paulo,65,1,2,2,not acept,3400,215,44,3659
Sao Paulo,139,3,2,0,acept,8000,103,102,8205
Porto Alegre,480,5,4,7,acept,3600,38,64,3702
Sao Paulo,60,1,1,1,not acept,1400,0,22,1422
Sao Paulo,50,2,1,1,acept,1305,49,17,1371
Belo Horizonte,70,2,1,1,acept,1400,0,23,1423
Porto Alegre,80,3,2,0,acept,2000,123,30,2153
Sao Paulo,100,1,4,1,acept,11000,250,166,11416
Campinas,194,3,2,3,acept,3500,75,53,3628
Sao Paulo,250,5,5,4,acept,2000,1249,26,3275
Rio de Janeiro,120,3,2,1,acept,4113,317,53,4483
Sao Paulo,80,2,1,2,acept,2000,18,31,2049
Sao Paulo,73,2,1,1,acept,1480,83,19,1582
Sao Paulo,122,2,1,2,acept,2360,67,36,2463
Belo Horizonte,24,1,1,0,not acept,680,0,10,690
Campinas,37,1,1,0,not acept,761,0,10,771
Sao Paulo,60,1,2,0,not acept,1600,23,25,1648
Sao Paulo,55,2,1,1,acept,1250,0,16,1266
Rio de Janeiro,300,4,2,2,acept,9000,834,116,9950
Sao Paulo,140,4,3,2,not acept,2600,117,40,2757
Sao Paulo,500,4,4,8,acept,15000,5200,191,20391
Sao Paulo,100,2,1,0,not acept,1100,25,17,1142
Sao Paulo,60,1,1,0,not acept,980,0,15,995
Sao Paulo,40,1,1,1,acept,3500,92,45,3637
Sao Paulo,70,2,1,1,not acept,2600,0,33,2633
Belo Horizonte,60,3,1,1,acept,1300,87,18,1405
Porto Alegre,350,3,3,3,acept,15000,667,267,15934
Sao Paulo,258,4,5,3,acept,5000,1084,64,6148
Belo Horizonte,220,4,4,0,not acept,8000,1067,107,9174
Sao Paulo,120,3,3,2,acept,9000,450,115,9565
Sao Paulo,223,3,4,3,acept,5500,880,83,6463
Porto Alegre,43,1,1,1,acept,1800,67,27,1894
Sao Paulo,215,3,3,4,acept,4800,275,73,5148
Sao Paulo,39,2,1,0,acept,1450,43,19,1512
Sao Paulo,35,1,1,0,acept,1400,0,18,1418
Belo Horizonte,15,1,1,0,not acept,1100,0,15,1115
Sao Paulo,600,4,3,3,acept,3750,1667,48,5465
Sao Paulo,600,4,4,4,acept,6800,1000,103,7903
Sao Paulo,52,2,1,1,acept,1658,37,22,1717
Campinas,200,3,3,5,acept,2650,220,40,2910
Sao Paulo,200,3,2,3,acept,2900,334,44,3278
Porto Alegre,47,1,1,1,not acept,2200,0,33,2233
Sao Paulo,60,1,1,1,not acept,2023,0,26,2049
Sao Paulo,57,2,2,1,acept,4150,140,53,4343
Sao Paulo,57,2,2,1,not acept,4500,140,58,4698
Sao Paulo,76,3,2,0,acept,1600,54,21,1675
Belo Horizonte,130,3,2,0,acept,2149,0,36,2185
Sao Paulo,96,3,3,1,acept,2290,125,30,2445
Sao Paulo,70,2,2,1,acept,1000,138,13,1151
Sao Paulo,90,3,3,2,acept,1997,280,26,2303
Sao Paulo,85,2,1,1,acept,1515,0,20,1535
Sao Paulo,25,1,1,0,acept,1650,30,21,1701
Rio de Janeiro,40,2,1,1,acept,1000,65,13,1078
Sao Paulo,71,2,2,2,acept,3000,84,39,3123
Belo Horizonte,120,3,2,2,not acept,1300,166,18,1484
Rio de Janeiro,62,2,1,1,not acept,1600,50,21,1671
Sao Paulo,215,3,1,3,acept,7000,417,106,7523
Sao Paulo,190,3,3,3,acept,4500,834,58,5392
Porto Alegre,190,4,3,1,acept,6450,117,85,6652
Rio de Janeiro,220,4,2,1,acept,5000,362,65,5427
Rio de Janeiro,373,3,2,2,acept,8500,678,110,9288
Sao Paulo,900,5,5,5,not acept,15000,3334,226,18560
Belo Horizonte,100,3,2,2,acept,1600,183,22,1805
Rio de Janeiro,180,4,2,1,acept,3000,507,39,3546
Sao Paulo,100,1,2,2,not acept,5000,309,64,5373
Sao Paulo,58,2,2,2,acept,2100,135,27,2262
Sao Paulo,110,3,3,3,acept,5000,0,64,5064
Sao Paulo,100,2,3,2,acept,6028,353,77,6458
Sao Paulo,75,2,1,1,acept,2450,0,37,2487
Sao Paulo,78,3,2,1,not acept,1900,205,25,2130
Sao Paulo,152,3,3,1,not acept,5200,213,66,5479
Campinas,42,1,1,1,not acept,1200,134,16,1350
Sao Paulo,50,1,1,0,acept,1200,0,19,1219
Sao Paulo,150,2,2,2,acept,2640,0,40,2680
Rio de Janeiro,56,2,2,1,acept,2800,150,37,2987
Sao Paulo,250,3,3,0,acept,3200,50,49,3299
Campinas,197,3,4,4,acept,9000,500,115,9615
Sao Paulo,348,4,4,1,acept,7511,215,96,7822
Sao Paulo,300,4,2,6,acept,5000,250,76,5326
Sao Paulo,300,4,5,4,acept,5500,959,70,6529
Campinas,60,3,1,1,not acept,1800,50,23,1873
Sao Paulo,200,3,4,2,acept,7000,459,89,7548
Campinas,900,3,6,8,acept,15000,1834,226,17060
Sao Paulo,50,2,1,1,not acept,1400,84,22,1506
Belo Horizonte,63,2,1,1,not acept,900,0,12,912
Porto Alegre,80,1,1,0,acept,800,40,15,855
Porto Alegre,600,5,7,5,acept,7000,834,125,7959
Belo Horizonte,456,4,2,0,acept,3080,520,51,3651
Sao Paulo,44,1,1,0,acept,3200,0,41,3241
Sao Paulo,35,1,1,1,acept,4000,200,51,4251
Sao Paulo,399,3,5,4,acept,12000,0,153,12153
Rio de Janeiro,100,3,1,0,acept,3700,396,48,4144
Sao Paulo,40,1,1,1,acept,1500,75,20,1595
Campinas,100,2,1,3,acept,1250,100,19,1369
Campinas,90,3,1,1,acept,960,83,13,1056
Sao Paulo,150,2,3,3,acept,3100,213,47,3360
Campinas,55,1,1,1,acept,2600,73,33,2706
Porto Alegre,135,4,4,1,acept,3200,300,47,3547
Belo Horizonte,350,3,2,6,acept,3800,173,63,4036
Sao Paulo,88,3,2,1,not acept,1700,0,22,1722
Rio de Janeiro,75,2,2,1,acept,2800,138,37,2975
Sao Paulo,128,3,3,0,acept,12000,500,153,12653
Sao Paulo,30,1,1,0,not acept,2000,0,26,2026
Campinas,132,4,2,2,acept,3300,164,42,3506
Sao Paulo,100,2,3,1,not acept,1500,117,23,1640
Sao Paulo,50,2,3,0,not acept,1740,84,27,1851
Porto Alegre,121,3,2,2,acept,2650,135,39,2824
Sao Paulo,279,5,5,6,acept,4420,834,57,5311
Rio de Janeiro,37,1,1,0,not acept,4700,0,61,4761
Sao Paulo,240,3,3,2,acept,2500,25,38,2563
Sao Paulo,164,3,3,1,not acept,6300,117,80,6497
Sao Paulo,65,2,2,2,acept,5000,110,64,5174
Belo Horizonte,127,2,2,0,acept,2000,158,27,2185
Sao Paulo,78,3,1,2,acept,3200,100,41,3341
Belo Horizonte,65,2,1,1,acept,900,27,12,939
Belo Horizonte,66,2,1,1,acept,1000,25,14,1039
Sao Paulo,185,3,3,2,acept,12000,0,153,12153
Belo Horizonte,420,4,4,5,acept,9000,0,148,9148
Sao Paulo,70,2,1,0,acept,3000,0,46,3046
Sao Paulo,37,1,1,0,acept,1500,0,20,1520
Rio de Janeiro,30,1,1,0,acept,750,13,10,773
Sao Paulo,300,2,3,2,acept,3200,0,49,3249
Sao Paulo,72,2,2,1,acept,3990,0,51,4041
Sao Paulo,230,4,3,1,not acept,3600,464,46,4110
Belo Horizonte,52,2,2,1,acept,900,59,12,971
Campinas,26,1,1,0,acept,500,13,7,520
Sao Paulo,113,2,1,1,acept,3000,50,39,3089
Belo Horizonte,178,3,2,2,acept,1660,154,23,1837
Rio de Janeiro,60,1,1,1,not acept,1700,459,22,2181
Sao Paulo,189,3,3,0,acept,4100,375,52,4527
Campinas,250,4,4,0,acept,3825,369,58,4252
Sao Paulo,120,3,2,2,acept,5500,322,70,5892
Sao Paulo,237,4,3,4,not acept,5000,1042,64,6106
Rio de Janeiro,168,3,2,3,acept,13200,637,171,14008
Sao Paulo,20,1,1,0,acept,1800,130,23,1953
Campinas,55,1,1,1,acept,700,45,9,754
Rio de Janeiro,90,3,2,1,not acept,2550,364,33,2947
Campinas,190,2,2,0,not acept,1300,200,17,1517
Porto Alegre,44,1,1,0,acept,940,13,14,967
Sao Paulo,210,3,2,0,acept,4000,442,51,4493
Belo Horizonte,230,3,4,4,acept,15000,130,200,15330
Sao Paulo,300,3,3,4,acept,6500,1417,83,8000
Belo Horizonte,400,6,4,0,acept,15000,375,246,15621
Sao Paulo,273,3,3,1,acept,4250,778,54,5082
Sao Paulo,200,4,4,3,acept,5000,1211,64,6275
Sao Paulo,121,3,3,2,acept,3750,255,57,4062
Rio de Janeiro,40,1,1,0,acept,2200,68,29,2297
Sao Paulo,55,1,1,0,not acept,1824,0,24,1848
Sao Paulo,120,1,1,2,acept,2190,300,28,2518
Campinas,144,3,2,3,acept,4000,138,61,4199
Campinas,60,2,1,1,acept,1000,0,13,1013
Sao Paulo,60,1,1,2,not acept,1500,50,20,1570
Rio de Janeiro,49,1,1,0,acept,1235,0,16,1251
Porto Alegre,107,3,3,2,acept,4270,250,63,4583
Campinas,202,3,2,4,acept,3500,608,53,4161
Sao Paulo,60,1,1,1,not acept,5440,277,69,5786
Sao Paulo,156,3,4,2,acept,2000,0,26,2026
Rio de Janeiro,100,3,1,0,acept,2200,199,29,2428
Sao Paulo,70,2,2,0,not acept,3200,0,41,3241
Sao Paulo,45,1,1,0,not acept,3850,0,49,3899
Rio de Janeiro,100,3,1,1,acept,1400,42,19,1461
Campinas,52,1,1,1,acept,3000,59,39,3098
Sao Paulo,120,3,2,2,acept,5000,250,76,5326
Porto Alegre,80,3,2,2,acept,2350,100,35,2485
Sao Paulo,320,4,2,2,acept,8000,642,121,8763
Sao Paulo,90,2,2,1,acept,3000,50,39,3089
Belo Horizonte,139,4,1,2,not acept,4200,390,56,4646
Sao Paulo,400,3,3,4,acept,3650,0,55,3705
Sao Paulo,320,3,5,8,not acept,9000,567,136,9703
Sao Paulo,63,3,2,1,not acept,2273,0,29,2302
Porto Alegre,40,1,1,1,not acept,1200,68,18,1286
Rio de Janeiro,135,3,2,2,not acept,2600,141,34,2775
Rio de Janeiro,100,3,2,1,acept,1870,75,25,1970
Belo Horizonte,274,4,5,5,not acept,13000,179,174,13353
Rio de Janeiro,70,1,1,0,not acept,5000,0,65,5065
Sao Paulo,240,3,1,2,acept,4000,1449,51,5500
Campinas,97,1,1,0,acept,720,61,10,791
Campinas,270,3,3,5,acept,7500,459,113,8072
Rio de Janeiro,160,3,2,0,not acept,6500,258,84,6842
Belo Horizonte,20,1,1,1,acept,1100,0,15,1115
Campinas,55,1,1,0,acept,716,12,10,738
Porto Alegre,45,1,1,1,acept,1020,21,15,1056
Campinas,85,2,1,0,acept,680,0,9,689
Sao Paulo,130,3,4,2,acept,5500,0,70,5570
Sao Paulo,95,3,2,0,acept,2300,125,35,2460
Sao Paulo,70,3,2,1,acept,1600,84,21,1705
Sao Paulo,65,2,2,2,acept,6000,500,77,6577
Rio de Janeiro,150,3,2,0,acept,1930,298,25,2253
Belo Horizonte,93,3,3,2,not acept,1500,76,20,1596
Sao Paulo,30,1,1,0,not acept,1000,0,16,1016
Sao Paulo,200,4,4,2,not acept,8000,850,121,8971
Sao Paulo,350,4,5,4,acept,15000,0,191,15191
Porto Alegre,140,3,2,2,acept,4000,142,72,4214
Sao Paulo,431,3,3,2,not acept,15000,1370,191,16561
Campinas,50,1,1,1,acept,991,36,13,1040
Sao Paulo,70,3,1,1,acept,1340,117,17,1474
Sao Paulo,260,2,5,5,acept,8000,1417,121,9538
Belo Horizonte,500,8,5,8,acept,5000,150,82,5232
Sao Paulo,114,2,2,1,acept,2000,0,26,2026
Belo Horizonte,90,3,2,1,acept,1000,84,14,1098
Belo Horizonte,350,5,2,7,acept,9000,602,148,9750
Sao Paulo,190,4,4,2,acept,3200,134,41,3375
Sao Paulo,90,3,3,2,acept,2000,50,31,2081
Sao Paulo,340,5,6,5,not acept,8000,2100,102,10202
Sao Paulo,160,3,4,4,not acept,2500,292,38,2830
Sao Paulo,45,2,1,0,not acept,1190,0,16,1206
Rio de Janeiro,60,2,1,0,acept,1840,0,24,1864
Sao Paulo,66,2,1,1,not acept,3800,84,27,3911
Porto Alegre,60,1,1,0,acept,1390,34,21,1445
Belo Horizonte,180,6,4,6,acept,5500,209,91,5800
Sao Paulo,200,4,4,4,acept,4900,1167,63,6130
Belo Horizonte,160,3,2,2,acept,4320,100,71,4491
Rio de Janeiro,55,1,1,0,acept,2600,50,34,2684
Sao Paulo,290,3,4,3,acept,8770,1834,112,10716
Rio de Janeiro,33,1,1,0,not acept,2500,0,33,2533
Sao Paulo,100,3,2,1,acept,1700,30,26,1756
Sao Paulo,340,4,3,0,acept,5200,667,79,5946
Sao Paulo,70,1,2,1,acept,3800,125,49,3974
Sao Paulo,80,1,1,4,acept,1000,75,16,1091
Campinas,53,1,1,1,not acept,650,36,9,695
Rio de Janeiro,70,2,2,1,acept,1710,44,23,1777
Campinas,411,4,5,4,acept,5500,667,83,6250
Sao Paulo,240,3,4,3,acept,5500,750,83,6333
Sao Paulo,300,6,7,5,not acept,8000,0,121,8121
Campinas,67,2,2,2,acept,1030,84,14,1128
Sao Paulo,120,3,3,2,acept,3500,122,53,3675
Rio de Janeiro,40,1,1,0,acept,1810,0,24,1834
Belo Horizonte,169,3,2,4,acept,3200,109,53,3362
Sao Paulo,200,4,4,3,not acept,6141,997,78,7216
Belo Horizonte,360,1,1,8,acept,2190,167,36,2393
Rio de Janeiro,400,4,4,2,acept,15000,917,229,16146
Rio de Janeiro,60,2,1,0,acept,1600,59,21,1680
Sao Paulo,250,3,3,3,acept,4600,0,70,4670
Porto Alegre,47,1,1,1,not acept,2200,0,33,2233
Sao Paulo,48,2,1,0,acept,1200,0,16,1216
Campinas,92,3,3,2,acept,1700,167,22,1889
Sao Paulo,140,2,2,1,not acept,3000,190,39,3229
Belo Horizonte,22,1,1,0,acept,450,13,6,469
Porto Alegre,140,2,3,2,acept,3000,113,44,3157
Campinas,83,2,2,2,acept,3700,234,47,3981
Sao Paulo,380,3,5,4,acept,5500,1200,83,6783
Rio de Janeiro,200,4,2,1,not acept,3800,321,49,4170
Porto Alegre,18,1,1,0,not acept,1090,0,16,1106
Rio de Janeiro,290,4,4,0,acept,15000,750,229,15979
Sao Paulo,115,3,2,2,acept,2900,400,37,3337
Porto Alegre,100,3,2,2,acept,2455,125,36,2616
Sao Paulo,250,4,3,3,acept,2430,1167,31,3628
Sao Paulo,84,3,3,2,acept,8700,375,111,9186
Sao Paulo,120,2,2,2,acept,4000,500,51,4551
Rio de Janeiro,95,3,2,1,acept,2600,443,34,3077
Sao Paulo,27,1,1,0,not acept,3500,1,45,3546
Belo Horizonte,58,2,2,1,acept,999,99,14,1112
Porto Alegre,40,1,1,0,acept,700,9,11,720
Sao Paulo,90,2,1,0,not acept,1450,50,22,1522
Belo Horizonte,65,2,1,1,acept,1100,70,15,1185
Porto Alegre,400,4,2,2,acept,6300,500,92,6892
Rio de Janeiro,300,3,4,1,acept,9100,700,118,9918
Sao Paulo,249,3,3,1,acept,7000,420,89,7509
Belo Horizonte,80,2,1,1,not acept,1200,67,16,1283
Sao Paulo,60,2,1,1,acept,1343,0,18,1361
Sao Paulo,190,3,2,1,acept,8000,556,102,8658
Belo Horizonte,95,3,2,2,acept,3100,219,42,3361
Sao Paulo,125,2,1,1,acept,1490,74,23,1587
Sao Paulo,107,2,4,2,not acept,11000,417,140,11557
Rio de Janeiro,40,1,1,0,acept,2090,86,27,2203
Rio de Janeiro,170,2,3,1,acept,5000,225,65,5290
Campinas,140,1,2,2,acept,5200,284,66,5550
Rio de Janeiro,20,1,1,0,acept,850,5,11,866
Sao Paulo,39,1,1,1,acept,1700,95,22,1817
Campinas,150,3,2,4,acept,3500,186,53,3739
Sao Paulo,52,2,1,1,acept,950,23,13,986
Campinas,250,1,2,2,acept,2200,602,34,2836
Sao Paulo,238,4,3,1,acept,4500,575,58,5133
Sao Paulo,90,3,1,0,acept,1600,0,21,1621
Rio de Janeiro,310,3,2,0,not acept,6000,595,78,6673
Belo Horizonte,55,2,1,1,not acept,1600,75,22,1697
Rio de Janeiro,60,2,2,0,acept,2700,154,35,2889
Belo Horizonte,75,2,1,1,not acept,1250,0,17,1267
Sao Paulo,24,1,1,0,acept,870,0,14,884
Sao Paulo,340,4,5,3,not acept,12000,1287,153,13440
Sao Paulo,165,3,3,2,acept,2710,84,35,2829
Sao Paulo,84,2,2,1,not acept,2900,63,37,3000
Sao Paulo,126,2,1,0,acept,2580,0,33,2613
Porto Alegre,220,3,2,2,acept,2400,117,36,2553
Rio de Janeiro,135,4,2,1,acept,3300,115,51,3466
Rio de Janeiro,250,3,2,1,acept,2700,500,35,3235
Porto Alegre,40,1,1,0,acept,1200,159,18,1377
Sao Paulo,38,1,1,0,not acept,1000,46,13,1059
Sao Paulo,141,3,5,0,acept,10140,772,129,11041
Sao Paulo,61,1,2,1,acept,4000,140,51,4191
Sao Paulo,156,4,4,3,acept,2200,750,28,2978
Sao Paulo,230,3,5,3,not acept,11000,1100,140,12240
Porto Alegre,160,3,2,3,acept,3300,220,49,3569
Sao Paulo,280,4,4,2,acept,4000,1042,51,5093
Rio de Janeiro,98,2,1,0,acept,3900,184,51,4135
Sao Paulo,83,3,2,2,acept,7521,221,96,7838
Sao Paulo,150,3,3,2,not acept,13500,0,172,13672
Porto Alegre,63,2,1,1,not acept,1478,24,22,1524
Sao Paulo,285,4,4,4,acept,15000,973,191,16164
Rio de Janeiro,70,3,3,0,not acept,6000,332,78,6410
Rio de Janeiro,120,2,2,2,acept,12000,279,155,12434
Sao Paulo,80,2,1,0,acept,1400,165,22,1587
